0000 0000 0000 0000 0000 0000 0000 0000 0000 0000 0000 0000 0000 0000 0000 0000 0000 0000 0000 0000 0000 0000 0000 0000 0000 0000 0000 0000 0000 0000 0000 0000 0000 0000 0000 0000 0000 0000 0000 0000 
0000 0001 0001 0001 0001 0001 0001 0001 0001 0001 0001 0001 0001 0001 0001 0001 0001 0001 0001 0001 0001 0001 0001 0001 0000 0001 0001 0001 0001 0001 0001 0000 0001 0001 0001 0001 0001 0001 0001 0000 
0000 0001 0002 0002 0002 0002 0002 0002 0002 0002 0002 0002 0204 0002 0002 0002 0002 0002 0002 0002 0002 0002 0002 0001 0000 0001 0002 0002 0002 0103 0001 0000 0001 0002 0002 0002 0002 0002 0001 0000 
0000 0001 0002 0002 0002 0002 0002 0002 0002 0002 0002 0002 0204 0002 0002 0002 0002 0002 0002 0002 0002 0002 0002 0001 0000 0001 0002 0002 0002 0002 0001 0000 0001 0002 0002 0002 0002 0002 0001 0000 
0000 0001 0002 0002 0002 0001 0001 0001 0001 0001 0001 0001 0001 0001 0001 0001 0001 0001 0002 0002 0002 0002 0002 0001 0000 0001 0001 0001 0002 0002 0001 0000 0001 0002 0002 0002 0002 0002 0001 0000 
0000 0001 0002 0002 0002 0001 0000 0000 0000 0000 0000 0000 0000 0000 0000 0000 0000 0001 0002 0002 0002 0002 0002 0001 0000 0000 0000 0001 0002 0002 0001 0000 0001 0001 0001 0001 0001 0002 0001 0000 
0000 0001 0002 0002 0002 0001 0001 0001 0001 0001 0001 0001 0000 0001 0001 0001 0001 0001 0002 0002 0002 0002 0002 0001 0001 0001 0001 0001 0002 0002 0001 0000 0000 0000 0000 0000 0001 0002 0001 0000 
0000 0001 0002 0002 0002 0002 0002 0002 0002 0002 0002 0001 0000 0001 0002 0002 0002 0002 0002 0002 0002 0002 0002 0002 0002 0002 0002 0002 0002 0002 0001 0001 0001 0001 0001 0001 0001 0002 0001 0000 
0000 0001 0002 0002 0002 0002 0002 0002 0002 0002 0002 0001 0000 0001 0002 0002 0002 0002 0002 0001 0001 0001 0002 0002 0002 0002 0002 0002 0002 0002 0002 0002 0002 0002 0002 0002 0002 0002 0001 0000 
0000 0001 0001 0001 0001 0001 0001 0002 0002 0002 0002 0001 0000 0001 0001 0001 0001 0001 0001 0001 0000 0001 0001 0001 0001 0001 0001 0001 0001 0002 0002 0002 0002 0002 0002 0002 0001 0001 0001 0000 
0000 0000 0000 0000 0000 0000 0001 0002 0002 0002 0002 0001 0000 0000 0000 0000 0000 0000 0000 0000 0000 0000 0000 0000 0000 0000 0000 0000 0001 0002 0002 0002 0002 0002 0002 0002 0001 0000 0000 0000 
0000 0001 0001 0001 0001 0001 0001 0002 0002 0002 0002 0001 0000 0001 0001 0001 0001 0001 0001 0001 0001 0001 0001 0001 0001 0001 0001 0000 0001 0002 0002 0002 0002 0002 0002 0002 0001 0001 0001 0000 
0000 0002 0403 0002 0002 0304 0002 0002 0002 0002 0002 0001 0000 0001 0002 0002 0002 0002 0002 0002 0002 0002 0002 0002 0002 0002 0001 0000 0001 0001 0001 0001 0001 0001 0001 0002 0002 0002 0001 0000 
0000 0001 0001 0001 0001 0001 0001 0002 0002 0002 0002 0001 0000 0001 0002 0002 0002 0001 0001 0001 0001 0001 0001 0001 0001 0002 0001 0000 0000 0000 0000 0000 0000 0000 0001 0001 0002 0002 0001 0000 
0000 0000 0000 0000 0000 0000 0001 0002 0002 0002 0002 0001 0000 0001 0002 0503 0002 0001 0000 0000 0000 0000 0000 0000 0001 0002 0001 0001 0001 0001 0001 0001 0001 0001 0000 0001 0002 0002 0001 0000 
0000 0001 0001 0001 0001 0001 0001 0002 0002 0002 0002 0001 0000 0001 0002 0002 0002 0001 0001 0001 0001 0001 0001 0000 0001 0002 0002 0002 0002 0002 0002 0002 0002 0001 0000 0001 0002 0002 0001 0000 
0000 0001 0002 0002 0002 0002 0002 0002 0002 0002 0002 0001 0000 0001 0002 0002 0002 0002 0002 0002 0002 0002 0001 0000 0001 0002 0002 0002 0002 0002 0002 0002 0002 0001 0000 0001 0104 0104 0001 0000 
0000 0001 0002 0002 0002 0001 0001 0001 0001 0001 0001 0001 0000 0001 0001 0001 0001 0001 0001 0001 0002 0002 0001 0000 0001 0001 0001 0001 0001 0001 0002 0002 0002 0001 0000 0001 0002 0002 0001 0000 
0000 0001 0002 0002 0002 0001 0000 0000 0000 0000 0000 0000 0000 0000 0000 0000 0000 0000 0000 0001 0002 0002 0001 0000 0000 0000 0000 0000 0000 0001 0002 0002 0002 0001 0000 0001 0002 0002 0001 0000 
0000 0001 0002 0002 0002 0001 0000 0001 0001 0001 0001 0001 0001 0001 0001 0000 0001 0001 0001 0001 0002 0002 0001 0001 0001 0001 0001 0001 0000 0001 0002 0002 0002 0001 0000 0001 0002 0002 0001 0000 
0000 0001 0002 0002 0002 0001 0000 0001 0002 0002 0002 0002 0002 0002 0001 0000 0001 0002 0002 0002 0002 0002 0002 0002 0002 0002 0002 0001 0000 0001 0002 0002 0002 0001 0000 0001 0002 0002 0001 0000 
0000 0001 0002 0002 0002 0001 0000 0001 0002 0002 0002 0002 0002 0002 0001 0000 0001 0002 0002 0002 0002 0002 0002 0002 0002 0002 0002 0001 0000 0001 0504 0504 0504 0001 0000 0001 0002 0002 0001 0000 
0000 0001 0002 0002 0002 0001 0000 0001 0002 0002 0002 0002 0002 0002 0001 0000 0001 0002 0002 0002 0001 0001 0001 0001 0001 0001 0001 0001 0000 0001 0002 0002 0002 0001 0000 0001 0002 0002 0001 0000 
0000 0001 0002 0002 0002 0001 0001 0001 0002 0002 0002 0002 0002 0002 0001 0001 0001 0404 0404 0404 0001 0000 0000 0000 0000 0000 0000 0000 0000 0001 0002 0002 0002 0001 0000 0001 0002 0002 0001 0000 
0000 0001 0002 0002 0002 0002 0002 0002 0002 0002 0002 0002 0002 0002 0002 0002 0002 0002 0002 0002 0001 0000 0001 0001 0001 0001 0001 0001 0001 0001 0002 0002 0002 0001 0000 0001 0002 0002 0001 0000 
0000 0001 0002 0002 0002 0002 0002 0002 0002 0002 0001 0001 0001 0002 0002 0002 0002 0002 0002 0002 0001 0000 0001 0002 0002 0002 0002 0002 0002 0002 0002 0002 0002 0001 0000 0001 0002 0002 0001 0000 
0000 0001 0002 0002 0002 0002 0002 0002 0002 0002 0001 0000 0001 0002 0002 0002 0002 0002 0303 0002 0001 0000 0001 0002 0002 0002 0002 0002 0002 0002 0002 0002 0002 0001 0000 0001 0203 0002 0001 0000 
0000 0001 0002 0002 0002 0002 0002 0002 0002 0002 0001 0000 0001 0002 0002 0002 0002 0002 0002 0002 0001 0000 0001 0002 0002 0002 0002 0002 0002 0002 0002 0002 0002 0001 0000 0001 0002 0002 0001 0000 
0000 0001 0001 0001 0001 0001 0001 0001 0001 0001 0001 0000 0001 0001 0001 0001 0001 0001 0001 0001 0001 0000 0001 0001 0002 0002 0002 0002 0002 0001 0001 0001 0001 0001 0000 0001 0001 0001 0001 0000 
0000 0000 0000 0000 0000 0000 0000 0000 0000 0000 0000 0000 0000 0000 0000 0000 0000 0000 0000 0000 0000 0000 0000 0001 0002 0002 0002 0002 0002 0001 0000 0000 0000 0000 0000 0000 0000 0000 0000 0000 
