0001 0001 0001 0001 0001 0005 0001 0001 0001 0001 0001 0001 0001 0001 0001 0001 0001 0001 0001 0001 0001 0001 0001 0001 0001 0001 0001 0001 0001 0001 0001 0001 0001 0001 0001 0001 0001 0001 0001 0001 0001 0001 0001 0001 0001 0001 0001 0001 0001 0001 0001 0001 0001 0001 0001 0001 0001 0001 0001 0001 0001 0001 0001 0001 0001 0001 0001 0001 0001 0001 0001 0001 0001 0001 0001 0001 0001 0001 0001 0001 
0001 0000 0000 0000 0000 0000 0000 0000 0000 0000 0000 0000 0000 0000 0000 0000 0000 0000 0000 0000 0000 0000 0000 0000 0000 0000 0000 0000 0000 0000 0000 0000 0000 0000 0000 0000 0000 0000 0000 0000 0000 0000 0000 0000 0000 0000 0000 0000 0000 0000 0000 0000 0000 0000 0000 0000 0000 0000 0000 0000 0000 0000 0000 0000 0000 0000 0000 0000 0000 0000 0000 0000 0000 0000 0000 0000 0000 0000 0000 0001 
0001 0000 0002 0002 0002 0002 0603 0002 0000 0001 0002 0002 0002 0002 0002 0002 0002 0002 0002 0002 0002 0002 0002 0000 0001 0002 0002 0002 0002 0002 0002 0002 0002 0002 0002 0000 0001 0002 0303 0002 0002 0002 0002 0002 0002 0002 0002 0002 0002 0002 0002 0002 0002 0002 0002 0002 0002 0002 0002 0000 0001 0001 0001 0000 0002 0002 0002 0002 0002 0002 0002 0002 0002 0002 0002 0002 0002 0002 0000 0001 
0001 0000 0002 0002 0002 0002 0002 0002 0000 0001 0002 0002 0002 0002 0002 0002 0002 0002 0002 0002 0002 0002 0002 0000 0001 0002 0002 0002 0002 0002 0002 0002 0002 0002 0002 0000 0001 0002 0002 0002 0002 0002 0002 0002 0002 0002 0002 0002 0002 0002 0002 0002 0002 0002 0002 0002 0002 0002 0002 0000 0001 0002 0001 0000 0002 0002 0002 0002 0002 0002 0002 0002 0002 0002 0002 0002 0002 0002 0000 0001 
0001 0000 0002 0002 0000 0000 0000 0000 0000 0001 0002 0002 0002 0002 0002 0002 0002 0002 0002 0001 0000 0002 0002 0000 0001 0002 0002 0000 0001 0002 0002 0001 0001 0002 0002 0000 0001 0002 0002 0002 0002 0002 0002 0001 0001 0001 0001 0001 0001 0001 0001 0001 0001 0001 0001 0001 0001 0002 0002 0000 0001 0002 0001 0000 0002 0002 0001 0001 0001 0001 0001 0001 0001 0001 0001 0001 0002 0002 0000 0001 
0001 0000 0504 0504 0001 0001 0001 0001 0001 0001 0002 0002 0002 0002 0002 0002 0002 0002 0002 0001 0000 0002 0002 0000 0001 0002 0002 0000 0001 0002 0002 0000 0001 0002 0002 0000 0001 0002 0002 0002 0002 0002 0002 0001 0000 0000 0000 0000 0000 0000 0000 0000 0000 0000 0000 0000 0000 0002 0002 0000 0001 0002 0001 0000 0002 0002 0001 0000 0000 0000 0000 0000 0000 0000 0000 0001 0002 0002 0000 0001 
0001 0000 0002 0002 0002 0002 0002 0002 0002 0002 0002 0002 0000 0001 0002 0002 0002 0002 0002 0001 0000 0002 0002 0000 0001 0002 0002 0000 0001 0002 0002 0000 0001 0002 0002 0000 0005 0002 0002 0002 0002 0002 0002 0001 0000 0002 0002 0002 0002 0002 0002 0002 0002 0002 0002 0001 0000 0002 0002 0000 0001 0002 0002 0002 0002 0002 0001 0000 0002 0002 0002 0002 0002 0002 0000 0001 0002 0002 0000 0001 
0001 0000 0002 0002 0002 0002 0002 0002 0002 0002 0002 0002 0000 0001 0002 0002 0002 0002 0002 0001 0000 0002 0002 0000 0001 0002 0002 0000 0001 0002 0002 0000 0001 0002 0002 0000 0001 0002 0002 0002 0002 0002 0002 0001 0000 0002 0002 0002 0002 0002 0002 0002 0002 0002 0002 0001 0000 0002 0002 0000 0001 0002 0002 0002 0002 0002 0001 0000 0002 0002 0002 0002 0002 0002 0000 0001 0002 0002 0000 0001 
0001 0000 0002 0002 0002 0002 0002 0000 0000 0000 0000 0000 0000 0001 0002 0002 0001 0001 0001 0001 0000 0002 0002 0000 0000 0000 0000 0000 0001 0002 0002 0000 0001 0002 0002 0000 0001 0002 0002 0002 0002 0002 0002 0001 0000 0002 0002 0001 0001 0001 0001 0001 0001 0002 0002 0001 0000 0002 0002 0000 0001 0002 0001 0001 0001 0001 0001 0000 0002 0002 0001 0000 0002 0002 0000 0001 0002 0002 0000 0001 
0001 0000 0002 0002 0002 0002 0002 0000 0000 0000 0001 0001 0001 0001 0002 0002 0001 0000 0000 0000 0000 0002 0002 0000 0001 0001 0001 0001 0001 0002 0002 0000 0001 0002 0002 0000 0001 0002 0002 0002 0002 0002 0002 0001 0000 0002 0002 0001 0000 0000 0000 0000 0000 0002 0002 0001 0000 0002 0002 0000 0001 0002 0000 0000 0000 0000 0000 0000 0002 0002 0001 0000 0002 0002 0000 0001 0002 0002 0000 0001 
0001 0000 0002 0002 0002 0002 0002 0002 0001 0000 0002 0002 0002 0002 0002 0002 0001 0000 0002 0000 0000 0002 0002 0000 0001 0002 0002 0002 0002 0002 0002 0000 0001 0002 0002 0000 0001 0002 0002 0002 0002 0002 0002 0001 0000 0002 0002 0001 0000 0403 0002 0000 0000 0002 0002 0001 0000 0002 0002 0000 0001 0002 0002 0002 0002 0002 0002 0002 0002 0002 0001 0000 0002 0002 0000 0001 0002 0002 0000 0001 
0001 0000 0002 0002 0002 0002 0002 0002 0001 0000 0002 0002 0002 0002 0002 0002 0001 0000 0002 0002 0002 0002 0002 0000 0001 0002 0002 0002 0002 0002 0002 0000 0001 0002 0002 0000 0001 0002 0002 0002 0002 0002 0002 0001 0000 0002 0002 0001 0000 0002 0002 0000 0000 0002 0002 0001 0000 0002 0002 0000 0001 0002 0002 0002 0002 0002 0002 0002 0002 0002 0001 0000 0002 0002 0000 0001 0002 0002 0000 0001 
0001 0000 0000 0000 0000 0000 0002 0002 0001 0000 0002 0002 0001 0001 0001 0001 0001 0000 0002 0002 0002 0002 0002 0002 0002 0002 0002 0000 0000 0000 0000 0000 0001 0002 0002 0000 0001 0002 0002 0001 0001 0001 0001 0001 0000 0002 0002 0001 0000 0002 0002 0000 0000 0002 0002 0001 0000 0002 0002 0000 0001 0001 0001 0001 0001 0001 0001 0001 0001 0001 0001 0000 0002 0002 0000 0001 0002 0002 0000 0001 
0001 0000 0001 0001 0001 0001 0002 0002 0001 0000 0002 0002 0001 0000 0000 0000 0000 0000 0002 0002 0002 0002 0002 0002 0002 0002 0002 0000 0000 0000 0000 0000 0001 0002 0002 0000 0001 0002 0002 0001 0000 0000 0000 0000 0000 0002 0002 0001 0000 0304 0304 0000 0000 0002 0002 0001 0000 0002 0002 0000 0000 0000 0000 0000 0000 0000 0000 0000 0000 0000 0000 0000 0002 0002 0000 0001 0002 0002 0000 0001 
0001 0000 0002 0002 0002 0002 0002 0002 0001 0000 0002 0002 0001 0000 0002 0002 0002 0002 0002 0002 0002 0002 0002 0002 0002 0002 0002 0000 0000 0002 0503 0000 0001 0002 0002 0000 0001 0002 0002 0001 0000 0002 0002 0002 0002 0002 0002 0002 0002 0002 0002 0001 0000 0002 0002 0001 0000 0002 0002 0002 0002 0002 0001 0000 0002 0002 0002 0002 0002 0002 0001 0000 0002 0002 0000 0001 0002 0002 0000 0001 
0001 0000 0002 0002 0002 0002 0002 0002 0001 0000 0002 0002 0001 0000 0000 0000 0000 0000 0000 0000 0000 0000 0000 0000 0000 0000 0000 0000 0000 0002 0002 0000 0001 0002 0002 0000 0001 0002 0002 0001 0000 0000 0000 0000 0000 0000 0000 0000 0001 0002 0002 0001 0000 0002 0002 0001 0000 0000 0000 0000 0002 0002 0001 0000 0002 0002 0002 0002 0002 0002 0001 0000 0002 0002 0000 0001 0002 0002 0000 0001 
0001 0000 0002 0002 0002 0002 0002 0002 0001 0000 0002 0002 0001 0001 0001 0001 0001 0001 0001 0001 0001 0001 0001 0001 0000 0005 0000 0000 0000 0002 0002 0000 0001 0002 0002 0000 0001 0002 0002 0001 0001 0001 0001 0001 0001 0001 0001 0000 0001 0002 0002 0001 0000 0002 0002 0001 0001 0001 0001 0001 0002 0002 0001 0000 0002 0002 0002 0002 0002 0002 0001 0000 0002 0002 0000 0001 0002 0002 0000 0001 
0001 0000 0002 0002 0002 0002 0002 0002 0001 0000 0002 0002 0002 0002 0002 0002 0002 0002 0002 0002 0002 0002 0002 0001 0000 0002 0002 0002 0002 0002 0002 0000 0001 0002 0002 0000 0001 0002 0002 0002 0002 0002 0002 0002 0002 0002 0002 0000 0001 0002 0002 0001 0000 0002 0002 0002 0002 0002 0002 0002 0002 0002 0001 0000 0002 0002 0002 0002 0002 0002 0002 0002 0002 0002 0000 0001 0002 0002 0000 0001 
0001 0000 0002 0002 0002 0002 0002 0002 0001 0000 0002 0002 0002 0002 0002 0002 0002 0002 0002 0002 0002 0002 0002 0001 0000 0002 0002 0002 0002 0002 0002 0000 0001 0002 0002 0000 0001 0002 0002 0002 0002 0002 0002 0002 0002 0002 0002 0000 0001 0002 0002 0001 0000 0002 0002 0002 0002 0002 0002 0002 0002 0002 0001 0005 0002 0002 0002 0002 0002 0002 0002 0002 0002 0002 0000 0001 0002 0002 0000 0001 
0001 0000 0001 0001 0001 0001 0001 0001 0001 0000 0002 0002 0000 0000 0000 0000 0000 0000 0000 0000 0001 0002 0002 0001 0000 0002 0002 0000 0000 0000 0000 0000 0001 0002 0002 0000 0001 0001 0001 0001 0001 0001 0001 0001 0001 0002 0002 0000 0001 0002 0002 0001 0000 0001 0001 0001 0001 0001 0001 0001 0001 0001 0001 0000 0002 0002 0002 0002 0002 0002 0002 0002 0002 0002 0000 0001 0002 0002 0000 0001 
0001 0000 0000 0000 0000 0000 0000 0000 0000 0000 0002 0002 0000 0001 0001 0001 0001 0001 0001 0001 0001 0002 0002 0001 0000 0002 0002 0000 0001 0001 0001 0001 0001 0002 0002 0000 0000 0000 0000 0000 0000 0000 0000 0000 0001 0002 0002 0000 0001 0002 0002 0001 0000 0000 0000 0000 0000 0000 0000 0000 0000 0000 0000 0000 0002 0002 0002 0002 0002 0002 0002 0002 0002 0002 0000 0001 0002 0002 0000 0001 
0001 0000 0002 0002 0002 0002 0002 0002 0001 0000 0002 0002 0000 0001 0002 0002 0002 0002 0002 0002 0002 0002 0002 0001 0000 0002 0002 0000 0001 0002 0002 0002 0002 0002 0002 0000 0000 0002 0002 0002 0002 0002 0002 0002 0002 0002 0002 0000 0001 0002 0002 0001 0000 0002 0002 0002 0002 0002 0002 0002 0002 0002 0002 0002 0002 0002 0002 0002 0002 0002 0002 0002 0002 0002 0000 0001 0002 0002 0000 0001 
0001 0000 0002 0002 0002 0002 0002 0002 0001 0000 0002 0002 0000 0001 0002 0002 0002 0002 0002 0002 0002 0002 0002 0001 0000 0002 0002 0000 0001 0002 0002 0002 0002 0002 0002 0000 0000 0002 0002 0002 0002 0002 0002 0002 0002 0002 0002 0000 0001 0002 0002 0001 0000 0002 0002 0002 0002 0002 0002 0002 0002 0002 0002 0002 0002 0002 0002 0002 0002 0002 0002 0002 0002 0002 0000 0001 0002 0002 0000 0001 
0001 0000 0002 0002 0002 0002 0002 0002 0001 0000 0002 0002 0000 0001 0002 0002 0001 0001 0001 0001 0001 0001 0001 0001 0000 0002 0002 0000 0001 0002 0002 0001 0001 0001 0001 0000 0000 0002 0002 0001 0001 0001 0001 0001 0001 0001 0001 0000 0001 0002 0002 0001 0000 0002 0002 0002 0002 0002 0002 0000 0000 0000 0000 0000 0000 0000 0000 0000 0000 0000 0000 0000 0000 0000 0000 0001 0002 0002 0000 0001 
0001 0000 0002 0002 0002 0002 0002 0002 0001 0000 0002 0002 0000 0001 0002 0002 0001 0000 0000 0000 0000 0000 0000 0000 0000 0002 0002 0001 0001 0002 0002 0001 0000 0000 0000 0000 0000 0002 0002 0001 0000 0000 0000 0000 0000 0000 0000 0000 0001 0002 0002 0001 0000 0002 0002 0002 0103 0002 0002 0000 0001 0001 0001 0001 0001 0001 0001 0001 0001 0001 0001 0001 0001 0001 0001 0001 0104 0104 0000 0001 
0001 0000 0002 0002 0002 0002 0002 0002 0001 0000 0002 0002 0000 0001 0002 0002 0002 0002 0002 0002 0001 0000 0002 0002 0002 0002 0002 0002 0002 0002 0002 0001 0000 0001 0001 0001 0001 0002 0002 0002 0002 0002 0002 0000 0001 0002 0002 0002 0002 0002 0002 0001 0000 0002 0002 0002 0002 0002 0002 0000 0002 0002 0002 0002 0002 0002 0002 0002 0002 0002 0002 0002 0002 0002 0002 0002 0002 0002 0000 0001 
0001 0000 0002 0002 0002 0002 0002 0002 0001 0000 0002 0002 0000 0001 0002 0002 0002 0002 0002 0002 0001 0000 0002 0002 0002 0002 0002 0002 0002 0002 0002 0001 0000 0001 0002 0002 0002 0002 0002 0002 0002 0002 0002 0000 0001 0002 0002 0002 0002 0002 0002 0001 0000 0002 0002 0002 0002 0002 0002 0000 0002 0002 0002 0002 0002 0002 0002 0002 0002 0002 0002 0002 0002 0002 0002 0002 0002 0002 0000 0001 
0001 0000 0002 0002 0002 0002 0002 0001 0001 0000 0002 0002 0000 0000 0000 0000 0000 0001 0002 0002 0001 0000 0002 0002 0002 0001 0001 0001 0001 0001 0001 0001 0000 0001 0002 0002 0002 0002 0002 0002 0002 0002 0002 0000 0001 0002 0002 0001 0001 0001 0001 0001 0000 0001 0001 0001 0001 0001 0001 0000 0002 0002 0001 0001 0001 0001 0001 0001 0001 0001 0001 0001 0001 0001 0001 0001 0002 0002 0000 0001 
0604 0002 0002 0002 0002 0002 0002 0000 0000 0000 0002 0002 0000 0000 0000 0000 0000 0001 0002 0002 0001 0000 0002 0002 0002 0000 0000 0000 0000 0000 0000 0000 0000 0001 0002 0002 0002 0002 0002 0002 0002 0002 0002 0000 0001 0002 0002 0000 0000 0000 0000 0000 0000 0000 0000 0000 0000 0000 0000 0000 0002 0002 0001 0000 0000 0000 0000 0000 0000 0000 0000 0000 0000 0000 0000 0001 0002 0002 0000 0001 
0604 0002 0002 0002 0002 0002 0002 0002 0002 0002 0002 0002 0000 0001 0002 0002 0002 0002 0002 0002 0001 0000 0002 0002 0002 0002 0002 0002 0002 0002 0002 0001 0000 0001 0002 0002 0002 0002 0002 0002 0002 0002 0002 0000 0001 0002 0002 0002 0002 0002 0002 0002 0002 0002 0002 0002 0002 0002 0002 0000 0002 0002 0002 0002 0002 0002 0000 0000 0002 0002 0002 0002 0002 0002 0002 0002 0002 0002 0000 0001 
0604 0002 0002 0002 0002 0002 0002 0002 0002 0002 0002 0002 0000 0001 0002 0002 0002 0002 0002 0002 0001 0000 0002 0002 0002 0002 0002 0002 0002 0002 0002 0001 0000 0001 0002 0002 0002 0002 0002 0002 0002 0002 0002 0000 0001 0002 0002 0002 0002 0002 0002 0002 0002 0002 0002 0002 0002 0002 0002 0000 0002 0002 0002 0002 0002 0002 0000 0000 0002 0002 0002 0002 0002 0002 0002 0002 0002 0002 0000 0001 
0001 0000 0002 0002 0002 0002 0002 0000 0000 0000 0000 0000 0000 0001 0002 0002 0001 0001 0001 0001 0001 0000 0001 0001 0001 0001 0001 0001 0001 0002 0002 0001 0000 0001 0002 0002 0002 0002 0002 0001 0001 0001 0001 0000 0001 0001 0001 0001 0001 0001 0001 0001 0001 0001 0001 0001 0001 0002 0002 0000 0001 0001 0001 0001 0002 0002 0000 0000 0000 0000 0000 0000 0000 0000 0000 0000 0000 0000 0000 0001 
0001 0000 0002 0002 0002 0002 0002 0001 0001 0001 0001 0001 0001 0001 0002 0002 0000 0000 0000 0000 0000 0000 0000 0000 0000 0000 0000 0000 0000 0002 0002 0001 0001 0001 0002 0002 0002 0002 0002 0000 0000 0000 0000 0000 0000 0000 0000 0000 0000 0000 0000 0000 0000 0000 0000 0000 0000 0002 0002 0000 0000 0000 0000 0001 0002 0002 0001 0001 0001 0001 0001 0001 0001 0001 0001 0001 0001 0001 0000 0001 
0001 0000 0002 0002 0002 0002 0002 0002 0002 0002 0002 0002 0002 0002 0002 0002 0000 0001 0002 0002 0002 0002 0002 0002 0002 0002 0002 0001 0000 0002 0002 0002 0404 0002 0002 0002 0002 0002 0002 0000 0001 0002 0002 0002 0002 0002 0002 0002 0002 0002 0002 0002 0002 0002 0002 0001 0000 0002 0002 0002 0002 0002 0000 0001 0002 0002 0002 0002 0002 0002 0002 0002 0002 0002 0002 0002 0002 0002 0000 0001 
0001 0000 0002 0002 0002 0002 0002 0002 0002 0002 0002 0002 0002 0002 0002 0002 0000 0001 0002 0002 0002 0002 0002 0002 0002 0002 0002 0001 0000 0002 0002 0002 0404 0002 0002 0002 0002 0002 0002 0000 0001 0002 0002 0002 0002 0002 0002 0002 0002 0002 0002 0002 0002 0002 0002 0001 0000 0002 0002 0002 0002 0002 0000 0001 0002 0002 0002 0002 0002 0002 0002 0002 0002 0002 0002 0002 0002 0002 0000 0001 
0001 0005 0000 0000 0000 0000 0000 0000 0000 0000 0000 0000 0000 0000 0000 0000 0000 0001 0002 0000 0000 0000 0000 0000 0001 0002 0002 0001 0000 0000 0000 0000 0000 0000 0000 0005 0000 0000 0000 0000 0000 0000 0000 0000 0000 0000 0000 0000 0001 0002 0002 0001 0000 0002 0002 0001 0000 0001 0001 0001 0002 0002 0000 0001 0001 0001 0001 0001 0001 0001 0001 0001 0002 0002 0000 0001 0002 0002 0000 0001 
0001 0000 0001 0001 0001 0001 0001 0001 0000 0001 0001 0001 0001 0001 0001 0001 0000 0001 0002 0000 0001 0001 0001 0000 0001 0002 0002 0001 0001 0001 0001 0001 0001 0001 0001 0001 0001 0001 0001 0001 0001 0001 0001 0001 0001 0001 0001 0000 0001 0002 0002 0001 0000 0002 0002 0001 0000 0000 0000 0000 0002 0002 0000 0000 0000 0000 0000 0000 0000 0000 0000 0000 0002 0002 0000 0001 0002 0002 0000 0001 
0001 0000 0002 0002 0002 0002 0002 0002 0000 0001 0002 0002 0002 0002 0002 0002 0000 0001 0002 0000 0001 0002 0002 0000 0001 0002 0002 0002 0002 0002 0002 0002 0002 0002 0002 0002 0002 0002 0002 0002 0002 0002 0002 0002 0002 0002 0002 0000 0001 0002 0002 0001 0000 0002 0002 0002 0002 0002 0001 0000 0002 0002 0204 0002 0002 0002 0002 0002 0002 0002 0001 0000 0002 0002 0000 0001 0002 0002 0000 0001 
0001 0000 0002 0002 0002 0002 0002 0002 0000 0001 0002 0002 0002 0002 0002 0002 0000 0001 0002 0000 0001 0002 0002 0000 0001 0002 0002 0002 0002 0002 0002 0002 0002 0002 0002 0002 0002 0002 0002 0002 0002 0002 0002 0002 0002 0002 0002 0000 0001 0002 0002 0001 0000 0002 0002 0002 0002 0002 0001 0000 0002 0002 0204 0002 0002 0002 0002 0002 0002 0002 0001 0000 0002 0002 0000 0001 0002 0002 0000 0001 
0001 0000 0002 0002 0000 0001 0002 0002 0000 0001 0002 0002 0000 0001 0002 0002 0000 0001 0002 0000 0001 0002 0002 0000 0000 0000 0000 0000 0000 0002 0002 0000 0000 0000 0000 0000 0000 0000 0000 0000 0000 0000 0000 0000 0000 0002 0002 0000 0000 0000 0000 0000 0000 0002 0002 0001 0000 0002 0001 0000 0001 0001 0001 0001 0001 0001 0001 0001 0002 0002 0001 0000 0002 0002 0000 0001 0002 0002 0000 0001 
0001 0000 0002 0002 0000 0001 0002 0002 0000 0001 0002 0002 0000 0001 0002 0002 0000 0001 0002 0000 0001 0002 0002 0000 0001 0001 0001 0001 0001 0002 0002 0000 0001 0001 0001 0001 0001 0001 0001 0000 0001 0001 0001 0001 0000 0002 0002 0000 0001 0001 0001 0001 0001 0002 0002 0001 0000 0002 0001 0000 0000 0000 0000 0000 0000 0000 0000 0001 0002 0002 0001 0000 0002 0002 0000 0001 0002 0002 0000 0001 
0001 0000 0002 0002 0000 0001 0002 0002 0002 0002 0002 0002 0000 0001 0002 0002 0002 0002 0002 0000 0001 0002 0002 0000 0001 0002 0002 0002 0002 0002 0002 0000 0001 0002 0002 0002 0002 0002 0002 0000 0001 0002 0002 0001 0000 0002 0002 0000 0001 0002 0002 0002 0002 0002 0002 0001 0000 0002 0002 0002 0002 0002 0002 0002 0002 0002 0000 0001 0002 0002 0001 0000 0002 0002 0000 0001 0002 0002 0000 0001 
0001 0000 0002 0002 0000 0001 0002 0002 0002 0002 0002 0002 0000 0001 0002 0002 0002 0002 0002 0000 0001 0002 0002 0000 0001 0002 0002 0002 0002 0002 0002 0000 0001 0002 0002 0002 0002 0002 0002 0000 0001 0002 0002 0001 0000 0002 0002 0000 0001 0002 0002 0002 0002 0002 0002 0001 0000 0002 0002 0002 0002 0002 0002 0002 0002 0002 0000 0001 0002 0002 0001 0000 0002 0002 0000 0001 0002 0002 0000 0001 
0001 0000 0002 0002 0000 0000 0000 0000 0000 0000 0000 0000 0000 0000 0000 0000 0000 0000 0000 0000 0001 0002 0002 0000 0001 0002 0002 0000 0001 0002 0002 0000 0001 0002 0002 0002 0002 0002 0002 0000 0001 0002 0002 0001 0000 0002 0002 0000 0001 0002 0002 0001 0001 0001 0001 0001 0000 0001 0001 0001 0002 0002 0000 0000 0000 0000 0000 0001 0002 0002 0001 0000 0002 0002 0000 0001 0002 0002 0000 0001 
0001 0000 0002 0002 0000 0001 0001 0001 0001 0001 0001 0001 0001 0001 0001 0001 0001 0001 0001 0001 0001 0002 0002 0000 0001 0002 0002 0000 0001 0002 0002 0000 0001 0002 0002 0002 0002 0002 0002 0000 0001 0002 0002 0001 0000 0002 0002 0001 0001 0002 0002 0000 0000 0000 0000 0005 0000 0000 0000 0001 0002 0002 0000 0001 0001 0001 0001 0001 0002 0002 0001 0000 0002 0002 0000 0001 0002 0002 0000 0001 
0001 0000 0002 0002 0000 0001 0002 0002 0002 0002 0002 0002 0002 0002 0002 0002 0002 0002 0002 0002 0002 0002 0002 0000 0001 0002 0002 0000 0001 0002 0002 0000 0001 0002 0002 0002 0002 0002 0002 0000 0001 0002 0002 0001 0000 0002 0002 0002 0002 0002 0002 0000 0001 0002 0002 0002 0002 0002 0000 0001 0002 0002 0000 0001 0002 0002 0002 0002 0002 0002 0001 0000 0002 0002 0000 0001 0002 0002 0000 0001 
0001 0000 0002 0002 0000 0001 0002 0002 0000 0001 0002 0002 0002 0002 0002 0002 0002 0002 0002 0002 0002 0002 0002 0000 0001 0002 0002 0000 0001 0001 0001 0000 0001 0002 0002 0002 0002 0002 0002 0000 0001 0002 0002 0001 0000 0000 0000 0000 0000 0002 0002 0000 0001 0002 0002 0002 0002 0002 0000 0001 0002 0002 0000 0001 0002 0002 0000 0000 0000 0000 0000 0000 0000 0000 0000 0001 0002 0002 0000 0001 
0001 0000 0002 0002 0000 0001 0002 0002 0000 0001 0002 0002 0203 0002 0002 0002 0002 0002 0002 0000 0001 0002 0002 0000 0001 0002 0002 0000 0000 0000 0000 0000 0005 0002 0002 0002 0002 0002 0002 0000 0001 0002 0002 0001 0001 0001 0001 0001 0001 0002 0002 0000 0001 0002 0002 0002 0002 0002 0000 0001 0002 0002 0000 0001 0002 0002 0001 0001 0001 0001 0000 0001 0001 0001 0001 0001 0002 0002 0000 0001 
0001 0000 0002 0002 0002 0002 0002 0002 0000 0001 0002 0002 0002 0002 0002 0002 0002 0002 0002 0000 0001 0002 0002 0000 0001 0002 0002 0002 0002 0002 0002 0000 0001 0002 0002 0002 0002 0002 0002 0000 0001 0002 0002 0002 0002 0002 0002 0002 0002 0002 0002 0000 0001 0002 0002 0002 0002 0002 0000 0001 0002 0002 0000 0001 0002 0002 0002 0002 0002 0002 0000 0001 0002 0002 0002 0002 0002 0002 0000 0001 
0001 0000 0002 0002 0002 0002 0002 0002 0000 0001 0002 0002 0002 0002 0002 0002 0002 0002 0002 0000 0001 0002 0002 0000 0001 0002 0002 0002 0002 0002 0002 0000 0001 0002 0002 0002 0002 0002 0002 0000 0001 0002 0002 0002 0002 0002 0002 0002 0002 0002 0002 0000 0001 0002 0002 0002 0002 0002 0000 0001 0002 0002 0000 0001 0002 0002 0002 0002 0002 0002 0000 0001 0002 0002 0002 0002 0002 0002 0000 0001 
0001 0000 0001 0001 0001 0001 0001 0001 0000 0001 0001 0005 0002 0002 0002 0002 0002 0002 0002 0000 0000 0000 0000 0000 0000 0000 0000 0000 0000 0002 0002 0000 0001 0002 0002 0002 0002 0002 0002 0000 0000 0000 0000 0000 0000 0000 0000 0000 0000 0000 0000 0000 0001 0002 0002 0002 0002 0002 0000 0000 0000 0000 0000 0000 0000 0000 0000 0000 0002 0002 0000 0001 0002 0002 0000 0000 0000 0000 0000 0001 
0001 0000 0000 0000 0000 0000 0000 0000 0000 0000 0000 0000 0002 0002 0002 0002 0002 0002 0002 0000 0001 0001 0001 0001 0001 0001 0001 0001 0001 0002 0002 0000 0001 0002 0002 0002 0002 0002 0002 0000 0001 0001 0001 0001 0001 0001 0001 0001 0001 0001 0001 0001 0001 0002 0002 0002 0002 0002 0001 0001 0001 0001 0000 0001 0001 0001 0001 0001 0002 0002 0000 0001 0002 0002 0001 0001 0001 0001 0000 0001 
0001 0000 0002 0002 0002 0002 0002 0002 0002 0002 0002 0002 0002 0002 0002 0002 0002 0002 0002 0000 0001 0002 0002 0002 0002 0002 0002 0002 0002 0002 0002 0000 0001 0002 0002 0002 0002 0002 0002 0000 0001 0002 0002 0002 0002 0002 0002 0002 0002 0002 0002 0002 0002 0002 0002 0002 0002 0002 0002 0002 0002 0002 0000 0001 0002 0002 0002 0002 0002 0002 0000 0001 0002 0002 0002 0002 0002 0002 0000 0001 
0001 0000 0002 0002 0002 0002 0002 0002 0002 0002 0002 0002 0002 0002 0002 0002 0002 0002 0002 0000 0001 0002 0002 0002 0002 0002 0002 0002 0002 0002 0002 0000 0001 0002 0002 0002 0002 0002 0002 0000 0001 0002 0002 0002 0002 0002 0002 0002 0002 0002 0002 0002 0002 0002 0002 0002 0002 0002 0002 0002 0002 0002 0000 0001 0002 0002 0002 0002 0002 0002 0000 0001 0002 0002 0002 0002 0002 0002 0000 0001 
0001 0000 0002 0002 0000 0000 0000 0000 0000 0000 0002 0002 0002 0002 0002 0002 0002 0002 0002 0000 0001 0002 0002 0000 0000 0000 0000 0000 0000 0000 0000 0000 0001 0002 0002 0000 0001 0002 0002 0000 0001 0002 0002 0002 0002 0002 0002 0002 0002 0002 0001 0001 0001 0001 0001 0001 0001 0002 0002 0002 0002 0002 0002 0002 0002 0002 0002 0002 0002 0001 0000 0001 0002 0002 0002 0002 0002 0002 0000 0001 
0001 0000 0002 0002 0001 0001 0001 0001 0001 0000 0002 0002 0002 0002 0002 0002 0002 0002 0002 0000 0001 0002 0002 0001 0001 0001 0001 0001 0001 0001 0001 0001 0001 0002 0002 0000 0001 0002 0002 0000 0001 0002 0002 0002 0002 0002 0002 0002 0002 0002 0000 0000 0000 0000 0000 0000 0001 0002 0002 0002 0002 0002 0002 0002 0002 0002 0002 0002 0002 0001 0001 0001 0002 0002 0002 0002 0002 0002 0000 0001 
0001 0000 0002 0002 0002 0002 0002 0002 0001 0000 0002 0002 0002 0002 0002 0002 0002 0002 0002 0000 0001 0002 0002 0002 0002 0002 0002 0002 0002 0002 0002 0002 0002 0002 0002 0000 0001 0002 0002 0002 0002 0002 0002 0002 0002 0002 0002 0002 0002 0002 0002 0002 0002 0002 0002 0000 0001 0002 0002 0002 0002 0002 0002 0002 0002 0002 0002 0002 0002 0002 0002 0002 0002 0002 0002 0002 0002 0002 0000 0001 
0001 0000 0002 0002 0002 0002 0002 0002 0001 0000 0002 0002 0002 0002 0002 0002 0002 0002 0002 0000 0001 0002 0002 0002 0002 0002 0002 0002 0002 0002 0002 0002 0002 0002 0002 0000 0001 0002 0002 0002 0002 0002 0002 0002 0002 0002 0002 0002 0002 0002 0002 0002 0002 0002 0002 0000 0001 0002 0002 0002 0002 0002 0002 0002 0002 0002 0002 0002 0002 0002 0002 0002 0002 0002 0002 0002 0002 0002 0000 0001 
0001 0000 0000 0000 0000 0000 0000 0000 0000 0000 0000 0000 0000 0000 0000 0000 0000 0000 0000 0000 0000 0000 0000 0000 0000 0000 0000 0000 0000 0000 0000 0000 0000 0000 0000 0000 0000 0000 0000 0000 0000 0000 0000 0000 0000 0000 0000 0000 0000 0000 0000 0000 0000 0000 0000 0000 0000 0000 0000 0000 0000 0000 0000 0000 0000 0000 0005 0000 0000 0000 0000 0000 0000 0000 0000 0000 0000 0000 0000 0001 
0001 0001 0001 0001 0001 0001 0001 0001 0001 0001 0001 0001 0001 0001 0001 0001 0001 0001 0001 0001 0001 0001 0001 0001 0001 0001 0001 0001 0001 0001 0001 0001 0001 0001 0001 0001 0001 0001 0001 0001 0001 0001 0001 0001 0001 0001 0001 0001 0001 0001 0001 0001 0001 0001 0001 0001 0001 0001 0001 0001 0001 0001 0001 0001 0001 0001 0001 0001 0001 0001 0001 0001 0001 0001 0001 0001 0001 0001 0001 0001 
