0000 0000 0000 0000 0000 0000 0000 0000 0000 0000 0000 0000 0000 0000 0000 0000 0000 0000 0000 0000 0000 0000 0000 0000 0000 0000 0000 0000 0000 0000 0000 0000 0000 0000 0000 0000 0000 0000 0000 0000 
0000 0000 0000 0000 0000 0000 0000 0000 0000 0000 0000 0000 0000 0000 0000 0000 0000 0000 0000 0000 0000 0000 0000 0000 0000 0000 0000 0000 0000 0000 0000 0000 0000 0000 0000 0000 0000 0000 0000 0000 
0000 0000 0001 0001 0001 0001 0001 0001 0001 0001 0000 0001 0001 0001 0001 0001 0000 0001 0001 0001 0001 0001 0001 0001 0001 0001 0001 0001 0001 0001 0001 0000 0001 0001 0001 0001 0001 0001 0000 0000 
0000 0000 0001 0005 0005 0005 0005 0005 0005 0001 0000 0001 0005 0005 0005 0001 0000 0001 0005 0005 0005 0005 0005 0005 0005 0005 0005 0005 0005 0005 0001 0000 0001 0005 0005 0005 0005 0001 0000 0000 
0000 0000 0001 0005 0005 0005 0005 0005 0005 0001 0000 0001 0005 0005 0005 0001 0000 0001 0005 0005 0005 0005 0005 0005 0005 0005 0005 0005 0005 0005 0001 0000 0001 0005 0005 0005 0005 0001 0000 0000 
0000 0000 0001 0005 0005 0005 0005 0005 0005 0001 0000 0001 0005 0210 0005 0001 0000 0001 0005 0005 0005 0005 0005 0005 0005 0005 0005 0005 0005 0005 0001 0000 0001 0005 0005 0005 0005 0001 0000 0000 
0000 0000 0001 0005 0005 0005 0005 0005 0005 0001 0000 0001 0005 0005 0005 0001 0000 0001 0005 0005 0005 0005 0005 0005 0005 0005 0005 0005 0005 0005 0001 0000 0001 0005 0005 0005 0005 0001 0000 0000 
0000 9999 0212 0005 0005 0005 0005 0005 0005 0001 0000 0001 0005 0005 0005 0001 0000 0001 0005 0005 0005 0005 0005 0005 0005 0005 0005 0005 0005 0005 0001 0000 0001 0005 0005 0005 0005 0001 0000 0000 
0000 0000 0001 0005 0005 0005 0005 0005 0005 0001 0001 0001 0005 0005 0005 0001 0000 0001 0005 0005 0005 0005 0001 0001 0001 0005 0005 0005 0005 0005 0001 0000 0001 0005 0005 0005 0005 0001 0000 0000 
0000 0000 0001 0005 0005 0005 0005 0005 0005 0005 0005 0005 0005 0005 0005 0001 0000 0001 0005 0005 0005 0005 0001 0000 0001 0005 0005 0005 0005 0005 0001 0000 0001 0005 0005 0005 0005 0001 0000 0000 
0000 0000 0001 0005 0005 0005 0005 0005 0005 0005 0005 0005 0005 0005 0005 0001 0000 0001 0005 0005 0005 0005 0001 0000 0001 0005 0005 0005 0005 0005 0001 0000 0001 0005 0005 0005 0005 0001 0000 0000 
0000 0000 0001 0005 0005 0005 0005 0005 0005 0005 0005 0005 0005 0005 0005 0001 0000 0001 0005 0005 0005 0005 0001 0000 0001 0005 0005 0005 0005 0005 0001 0000 0001 0005 0005 0005 0005 0001 0000 0000 
0000 0000 0001 0001 0001 0001 0001 0001 0001 0005 0005 0001 0001 0001 0001 0001 0000 0001 0005 0005 0005 0005 0001 0000 0001 0005 0005 0005 0005 0005 0001 0000 0001 0005 0005 0005 0005 0001 0000 0000 
0000 0000 0000 0000 0000 0000 0000 0000 0001 0112 0112 0001 0000 0000 0000 0000 0000 0001 0005 0005 0005 0005 0001 0000 0001 0005 0005 0005 0005 0005 0001 0000 0001 0005 0014 0005 0005 0001 0000 0000 
0000 0000 0001 0001 0001 0001 0001 0001 0001 0005 0005 0001 0001 0001 0001 0001 0001 0001 0005 0005 0005 0005 0001 0000 0001 0005 0005 0005 0005 0005 0001 0000 0001 0005 0005 0005 0005 0001 0000 0000 
0000 0000 0001 0005 0005 0005 0005 0005 0005 0005 0005 0005 0005 0005 0005 0005 0005 0005 0005 0005 0005 0005 0001 0000 0001 0005 0005 0005 0005 0005 0001 0000 0001 0005 0005 0005 0005 0001 0000 0000 
0000 0000 0001 0005 0005 0005 0005 0005 0005 0005 0005 0005 0005 0005 0005 0005 0005 0005 0005 0005 0005 0005 0001 0000 0001 0005 0005 0005 0005 0005 0001 0000 0001 0005 0005 0005 0005 0001 0000 0000 
0000 0000 0001 0005 0005 0005 0005 0005 0005 0005 0005 0005 0005 0005 0005 0005 0005 0005 0005 0005 0005 0005 0001 0000 0001 0005 0005 0005 0005 0005 0001 0000 0001 0005 0005 0005 0005 0001 0000 0000 
0000 0000 0001 0005 0005 0005 0005 0005 0005 0005 0005 0005 0005 0005 0005 0005 0005 0005 0005 0005 0005 0005 0001 0000 0001 0005 0005 0005 0005 0005 0001 0000 0001 0005 0005 0005 0005 0001 0000 0000 
0000 0000 0001 0005 0005 0005 0005 0005 0005 0005 0005 0005 0005 0005 0005 0005 0005 0005 0005 0005 0005 0005 0001 0000 0001 0005 0005 0005 0005 0005 0001 0000 0001 0005 0005 0005 0005 0001 0000 0000 
0000 0000 0001 0001 0001 0001 0001 0001 0001 0001 0001 0001 0001 0001 0005 0005 0005 0005 0005 0005 0005 0005 0001 0000 0001 0005 0005 0005 0005 0005 0001 0001 0001 0005 0005 0005 0005 0001 0000 0000 
0000 0000 0000 0000 0000 0000 0000 0000 0000 0000 0000 0000 0000 0001 0005 0005 0005 0005 0005 0005 0005 0005 0001 0000 0001 0005 0005 0005 0005 0005 0005 0005 0005 0005 0005 0005 0005 0001 0000 0000 
0000 0000 0001 0001 0001 0001 0001 0001 0001 0001 0001 0001 0000 0001 0005 0005 0005 0005 0005 0005 0005 0005 0001 0000 0001 0005 0005 0005 0005 0005 0005 0005 0005 0005 0005 0005 0005 0001 0000 0000 
0000 0000 0001 0005 0005 0005 0005 0005 0005 0005 0005 0001 0000 0001 0005 0005 0005 0005 0005 0005 0005 0005 0001 0000 0001 0005 0005 0005 0005 0005 0005 0005 0005 0005 0005 0005 0005 0001 0000 0000 
0000 0000 0001 0005 0005 0005 0005 0005 0005 0005 0005 0001 0001 0001 0005 0005 0005 0005 0005 0005 0005 0005 0001 0000 0001 0005 0005 0005 0005 0005 0005 0005 0005 0005 0005 0005 0005 0001 0000 0000 
0000 0000 0001 0005 0005 0005 0110 0005 0005 0005 0005 0005 0005 0005 0005 0005 0005 0005 0005 0005 0005 0005 0001 0000 0001 0005 0005 0005 0005 0005 0005 0005 0005 0005 0005 0005 0005 0001 0000 0000 
0000 0000 0001 0005 0005 0005 0005 0005 0005 0005 0005 0005 0005 0005 0005 0005 0005 0005 0005 0005 0005 0005 0001 0000 0001 0005 0005 0005 0005 0005 0005 0005 0005 0005 0005 0005 0005 0001 0000 0000 
0000 0000 0001 0001 0001 0001 0001 0001 0001 0001 0001 0001 0001 0001 0001 0001 0001 0001 0001 0001 0001 0001 0001 0000 0001 0001 0001 0001 0001 0001 0001 0001 0001 0001 0001 0001 0001 0001 0000 0000 
0000 0000 0000 0000 0000 0000 0000 0000 0000 0000 0000 0000 0000 0000 0000 0000 0000 0000 0000 0000 0000 0000 0000 0000 0000 0000 0000 0000 0000 0000 0000 0000 0000 0000 0000 0000 0000 0000 0000 0000 
0000 0000 0000 0000 0000 0000 0000 0000 0000 0000 0000 0000 0000 0000 0000 0000 0000 0000 0000 0000 0000 0000 0000 0000 0000 0000 0000 0000 0000 0000 0000 0000 0000 0000 0000 0000 0000 0000 0000 0000 
