00 00 00 00 00 00 00 00 00 00 00 00 00 00 00 00 
00 01 01 01 01 01 01 01 01 01 01 22 01 01 01 00 
00 01 12 01 01 01 01 01 01 01 01 01 01 01 01 00 
00 01 01 01 01 01 01 01 01 01 01 24 01 01 01 00 
00 01 01 01 01 01 01 01 01 01 01 01 01 01 01 00 
00 01 01 01 01 01 01 01 01 01 01 01 01 01 01 00 
00 01 01 01 01 01 01 01 01 01 01 01 01 01 01 00 
00 14 01 01 01 01 01 01 01 01 01 01 01 01 01 00 
00 00 00 00 00 00 00 00 00 00 00 00 00 00 00 00 
