0000 0000 0000 0000 0000 0000 0000 0000 0000 0000 0000 0000 0000 0000 0000 0000 0000 0000 0000 0000 0000 0000 0000 0000 0000 0000 0000 0000 0000 0000 0000 0000 0000 0000 0000 0000 0000 0000 0000 0000 
0000 0000 0000 0000 0000 0000 0000 0000 0000 0000 0000 0000 0000 0000 0000 0000 0000 0000 0000 0000 0000 0000 0000 0000 0000 0000 0000 0000 0000 0000 0000 0000 0000 0000 0000 0000 0000 0000 0000 0000 
0000 0000 0001 0001 0001 0001 0001 0001 0001 0001 0001 0000 0001 0001 0001 0001 0001 0000 0001 0001 0001 0001 0001 0001 0001 0001 0001 0001 0001 0001 0000 0001 0001 0001 0001 0001 0001 0001 0000 0000 
0000 0000 0001 0002 0002 0002 0002 0002 0002 0002 0001 0000 0001 0002 0002 0002 0001 0000 0001 0002 0002 0002 0002 0002 0002 0002 0002 0002 0002 0001 0000 0001 0002 0002 0002 0002 0002 0001 0000 0000 
0000 0000 0001 0002 0002 0002 0002 0002 0002 0002 0001 0000 0001 0002 0203 0002 0001 0000 0001 0002 0002 0002 0002 0002 0002 0002 0002 0002 0002 0001 0000 0001 0002 0002 0002 0002 0002 0001 0000 0000 
0000 0000 0001 0002 0002 0002 0002 0002 0002 0002 0001 0000 0001 0002 0002 0002 0001 0000 0001 0002 0002 0002 0002 0002 0002 0002 0002 0002 0002 0001 0000 0001 0002 0002 0002 0002 0002 0001 0000 0000 
0000 0000 0001 0002 0002 0002 0002 0002 0002 0002 0001 0000 0001 0002 0002 0002 0001 0000 0001 0002 0002 0002 0001 0001 0001 0002 0002 0002 0002 0001 0000 0001 0002 0002 0002 0002 0002 0001 0000 0000 
0000 0000 0204 0002 0002 0002 0002 0002 0002 0002 0001 0000 0001 0002 0002 0002 0001 0000 0001 0002 0002 0002 0001 0000 0001 0002 0002 0002 0002 0001 0000 0001 0002 0002 0002 0002 0002 0001 0000 0000 
0000 0000 0001 0002 0002 0002 0002 0002 0002 0002 0001 0000 0001 0002 0002 0002 0001 0000 0001 0002 0002 0002 0001 0000 0001 0002 0002 0002 0002 0001 0000 0001 0002 0002 0002 0002 0002 0001 0000 0000 
0000 0000 0001 0002 0002 0002 0002 0002 0002 0002 0001 0001 0001 0002 0002 0002 0001 0000 0001 0002 0002 0002 0001 0000 0001 0002 0002 0002 0002 0001 0000 0001 0002 0002 0002 0002 0002 0001 0000 0000 
0000 0000 0001 0002 0002 0002 0002 0002 0002 0002 0002 0002 0002 0002 0002 0002 0001 0000 0001 0002 0002 0002 0001 0000 0001 0002 0002 0002 0002 0001 0000 0001 0002 0002 0002 0002 0002 0001 0000 0000 
0000 0000 0001 0002 0002 0002 0002 0002 0002 0002 0002 0002 0002 0002 0002 0002 0001 0000 0001 0002 0002 0002 0001 0000 0001 0002 0002 0002 0002 0001 0000 0001 0002 0002 0002 0002 0002 0001 0000 0000 
0000 0000 0001 0001 0001 0001 0001 0001 0001 0001 0002 0001 0001 0001 0001 0001 0001 0000 0001 0002 0002 0002 0001 0000 0001 0002 0002 0002 0002 0001 0000 0001 0002 0002 0002 0002 0002 0001 0000 0000 
0000 0000 0000 0000 0000 0000 0000 0000 0000 0001 0104 0001 0000 0000 0000 0000 0000 0000 0001 0002 0002 0002 0001 0000 0001 0002 0002 0002 0002 0001 0000 0001 0002 0002 0002 0002 0002 0001 0000 0000 
0000 0000 0001 0001 0001 0001 0001 0001 0001 0001 0002 0001 0001 0001 0001 0001 0001 0001 0001 0002 0002 0002 0001 0000 0001 0002 0002 0002 0002 0001 0000 0001 0002 0002 0002 0002 0002 0001 0000 0000 
0000 0000 0001 0002 0002 0002 0002 0002 0002 0002 0002 0002 0002 0002 0002 0002 0002 0002 0002 0002 0002 0002 0001 0000 0001 0002 0002 0002 0002 0001 0000 0001 0002 0002 0002 0002 0002 0001 0000 0000 
0000 0000 0001 0002 0002 0002 0002 0002 0002 0002 0002 0002 0002 0002 0002 0002 0002 0002 0002 0002 0002 0002 0001 0000 0001 0002 0002 0002 0002 0001 0000 0001 0002 0002 0002 0002 0002 0001 0000 0000 
0000 0000 0001 0002 0002 0002 0002 0002 0002 0002 0002 0002 0002 0002 0002 0002 0002 0002 0002 0002 0002 0002 0001 0000 0001 0002 0002 0002 0002 0001 0000 0001 0002 0002 0002 0002 0002 0001 0000 0000 
0000 0000 0001 0001 0001 0001 0001 0001 0001 0001 0001 0001 0001 0001 0001 0001 0001 0001 0001 0002 0002 0002 0001 0000 0001 0002 0002 0002 0002 0001 0000 0001 0002 0002 0002 0002 0002 0001 0000 0000 
0000 0000 0000 0000 0000 0000 0000 0000 0000 0000 0000 0000 0000 0000 0000 0000 0000 0000 0001 0002 0002 0002 0001 0000 0001 0002 0002 0002 0002 0001 0000 0001 0002 0002 0002 0002 0002 0001 0000 0000 
0000 0000 0001 0001 0001 0001 0001 0001 0001 0001 0001 0001 0001 0001 0001 0001 0001 0001 0001 0002 0002 0002 0001 0000 0001 0002 0002 0002 0002 0001 0000 0001 0002 0002 0002 0002 0002 0001 0000 0000 
0000 0000 0001 0002 0002 0002 0002 0002 0002 0002 0002 0002 0002 0002 0002 0002 0002 0002 0002 0002 0002 0002 0001 0000 0001 0002 0002 0002 0002 0001 0000 0001 0002 0002 0002 0002 0002 0001 0000 0000 
0000 0000 0001 0002 0002 0002 0002 0002 0002 0002 0002 0002 0002 0002 0002 0002 0002 0002 0002 0002 0002 0002 0001 0000 0001 0002 0002 0002 0002 0001 0000 0001 0002 0002 0002 0002 0002 0001 0000 0000 
0000 0000 0001 0002 0002 0002 0002 0002 0002 0002 0002 0002 0002 0002 0002 0002 0002 0002 0002 0002 0002 0002 0001 0000 0001 0002 0002 0002 0002 0001 0001 0001 0002 0002 0002 0002 0002 0001 0000 0000 
0000 0000 0001 0002 0002 0002 0001 0001 0001 0001 0001 0001 0001 0001 0001 0001 0001 0001 0001 0001 0001 0001 0001 0000 0001 0002 0002 0002 0002 0002 0002 0002 0002 0002 0002 0002 0002 0001 0000 0000 
0000 0000 0001 0002 0103 0002 0001 0000 0000 0000 0000 0000 0000 0000 0000 0000 0000 0000 0000 0000 0000 0000 0000 0000 0001 0002 0002 0002 0002 0002 0002 0002 0002 0002 0002 0002 0002 0001 0000 0000 
0000 0000 0001 0002 0002 0002 0001 0000 0000 0000 0000 0000 0000 0000 0000 0000 0000 0000 0000 0000 0000 0000 0000 0000 0001 0002 0002 0002 0002 0002 0002 0002 0002 0002 0002 0002 0002 0001 0000 0000 
0000 0000 0001 0001 0001 0001 0001 0000 0000 0000 0000 0000 0000 0000 0000 0000 0000 0000 0000 0000 0000 0000 0000 0000 0001 0001 0001 0001 0001 0001 0001 0001 0001 0001 0001 0001 0001 0001 0000 0000 
0000 0000 0000 0000 0000 0000 0000 0000 0000 0000 0000 0000 0000 0000 0000 0000 0000 0000 0000 0000 0000 0000 0000 0000 0000 0000 0000 0000 0000 0000 0000 0000 0000 0000 0000 0000 0000 0000 0000 0000 
0000 0000 0000 0000 0000 0000 0000 0000 0000 0000 0000 0000 0000 0000 0000 0000 0000 0000 0000 0000 0000 0000 0000 0000 0000 0000 0000 0000 0000 0000 0000 0000 0000 0000 0000 0000 0000 0000 0000 0000 
