0002 0002 0002 0002 0002 0002 0002 0002 0002 0002 0002 0002 0002 0000 0000 0000 0000 0000 0000 0000 0000 0000 0000 0000 0000 0000 0000 0000 0000 0000 0000 0000 0000 0000 0000 0000 0000 0000 0000 0000 
0002 0001 0007 0007 0007 0007 0005 0007 0007 0007 0007 0001 0002 0006 0006 0006 0006 0006 0006 0006 0006 0006 0006 0006 0000 0006 0006 0006 0006 0006 0006 0000 0006 0006 0006 0006 0006 0006 0006 0000 
0002 0007 0007 0007 0007 0007 0007 0007 0007 0007 0007 0007 0212 0006 0006 0006 0006 0006 0006 0006 0006 0006 0006 0006 0000 0006 0006 0006 0006 0110 0006 0000 0006 0006 0006 0006 0006 0006 0006 0000 
0002 0007 0007 0007 0007 0007 0007 0007 0007 0007 0007 0007 0212 0006 0006 0006 0006 0006 0006 0006 0006 0006 0006 0006 0000 0006 0006 0006 0006 0006 0006 0000 0006 0006 0006 0006 0006 0006 0006 0000 
0002 0005 0007 0007 0007 0007 0007 0007 0007 0007 0007 0001 0002 0006 0006 0006 0006 0006 0006 0006 0006 0006 0006 0006 0000 0006 0006 0006 0006 0006 0006 0000 0006 0006 0006 0006 0006 0006 0006 0000 
0002 0001 0007 0007 0007 0007 0002 0002 0002 0002 0002 0002 0000 0000 0000 0000 0000 0006 0006 0006 0006 0006 0006 0006 0000 0000 0000 0000 0006 0006 0006 0000 0006 0006 0006 0006 0006 0006 0006 0000 
0002 0005 0007 0007 0007 0007 0007 0007 0007 0007 0007 0001 0000 0006 0006 0006 0006 0006 0006 0006 0006 0006 0006 0006 0006 0006 0006 0006 0006 0006 0006 0000 0000 0000 0000 0000 0000 0006 0006 0000 
0002 0007 0007 0007 0007 0007 0007 0007 0007 0007 0007 0007 0000 0006 0006 0006 0006 0006 0006 0006 0000 0006 0006 0006 0006 0006 0006 0006 0006 0006 0006 0006 0006 0006 0006 0006 0006 0006 0006 0000 
0002 0001 0007 0007 0007 0007 0007 0007 0007 0007 0007 0007 0000 0006 0006 0006 0006 0006 0006 0006 0000 0006 0006 0006 0006 0006 0006 0006 0006 0006 0006 0006 0006 0006 0006 0006 0006 0006 0006 0000 
0002 0002 0002 0007 0007 0007 0007 0007 0007 0007 0007 0007 0000 0006 0014 0006 0006 0006 0006 0006 0000 0006 0006 0006 0006 0006 0006 0006 0006 0006 0006 0006 0006 0006 0006 0006 0006 0006 0006 0000 
0002 0002 0001 0002 0002 0002 0002 0007 0007 0007 0007 0007 0000 0000 0000 0000 0000 0000 0000 0000 0000 0000 0000 0000 0000 0000 0000 0000 0006 0006 0006 0006 0006 0006 0006 0006 0000 0000 0000 0000 
0002 0002 0007 0007 0007 0312 0007 0007 0007 0007 0007 0007 0002 0001 0007 0007 0007 0007 0007 0007 0005 0007 0007 0007 0007 0007 0001 0000 0006 0006 0006 0006 0006 0006 0006 0006 0006 0006 0006 0000 
0002 0002 0410 0007 0007 0312 0007 0007 0007 0007 0007 0005 0002 0007 0007 0007 0007 0007 0007 0007 0007 0007 0007 0007 0007 0007 0007 0000 0006 0006 0006 0006 0006 0006 0006 0006 0006 0006 0006 0000 
0002 0002 0001 0002 0002 0002 0002 0007 0007 0007 0007 0007 0002 0007 0007 0007 0007 0007 0007 0007 0007 0007 0007 0007 0007 0007 0007 0000 0000 0000 0000 0000 0000 0000 0000 0006 0006 0006 0006 0000 
0002 0002 0002 0007 0007 0007 0007 0007 0007 0007 0007 0007 0002 0007 0007 0510 0007 0002 0002 0002 0002 0002 0002 0002 0007 0007 0007 0007 0007 0007 0007 0007 0007 0001 0000 0006 0006 0006 0006 0000 
0002 0001 0007 0007 0007 0007 0007 0007 0007 0007 0007 0007 0002 0007 0007 0007 0007 0001 0007 0007 0007 0007 0001 0002 0007 0007 0007 0007 0007 0007 0007 0007 0007 0002 0000 0006 0006 0006 0006 0000 
0002 0007 0007 0007 0007 0007 0007 0007 0007 0007 0007 0007 0002 0007 0007 0007 0007 0007 0007 0007 0007 0007 0007 0002 0007 0007 0007 0007 0007 0007 0007 0007 0007 0002 0000 0000 0112 0112 0000 0000 
0002 0007 0007 0007 0007 0007 0007 0007 0007 0007 0007 0001 0002 0001 0007 0007 0007 0007 0007 0007 0007 0007 0007 0002 0001 0007 0007 0005 0007 0007 0001 0007 0007 0002 0000 0006 0006 0006 0006 0000 
0002 0007 0007 0007 0007 0007 0002 0002 0002 0002 0002 0002 0002 0002 0002 0002 0002 0002 0002 0007 0007 0007 0001 0002 0002 0002 0002 0002 0002 0002 0002 0007 0007 0002 0000 0006 0006 0006 0006 0000 
0002 0001 0007 0007 0007 0007 0002 0001 0007 0007 0007 0005 0007 0007 0007 0001 0002 0001 0007 0007 0007 0007 0007 0007 0007 0007 0007 0001 0007 0001 0002 0007 0007 0002 0000 0006 0006 0006 0006 0000 
0002 0005 0007 0007 0007 0007 0002 0007 0007 0007 0007 0007 0007 0007 0007 0007 0007 0002 0007 0007 0007 0007 0007 0007 0007 0007 0007 0007 0007 0007 0002 0007 0007 0002 0000 0006 0006 0006 0006 0000 
0002 0007 0007 0007 0007 0007 0002 0007 0007 0007 0007 0007 0007 0007 0007 0007 0007 0002 0007 0007 0007 0007 0007 0007 0007 0007 0007 0007 0014 0007 0002 0512 0512 0002 0000 0006 0006 0006 0006 0000 
0002 0007 0007 0007 0007 0007 0002 0007 0007 0007 0007 0007 0007 0007 0007 0007 0007 0002 0007 0007 0007 0007 0007 0007 0007 0007 0007 0001 0007 0001 0002 0007 0007 0002 0000 0006 0006 0006 0006 0000 
0002 0005 0007 0007 0007 0007 0002 0001 0007 0007 0007 0007 0007 0007 0007 0007 0007 0002 0412 0412 0002 0002 0002 0002 0002 0002 0002 0002 0002 0002 0002 0007 0007 0002 0000 0006 0006 0006 0006 0000 
0002 0001 0007 0007 0007 0007 0007 0007 0007 0007 0007 0002 0007 0007 0007 0007 0007 0007 0007 0007 0002 0005 0001 0007 0007 0007 0005 0007 0007 0007 0005 0007 0007 0002 0000 0006 0006 0006 0006 0000 
0002 0007 0007 0007 0007 0007 0007 0007 0007 0007 0007 0002 0005 0007 0007 0007 0007 0007 0007 0007 0002 0007 0007 0007 0007 0007 0007 0007 0007 0007 0007 0007 0007 0002 0000 0006 0006 0006 0006 0000 
0002 0007 0007 0007 0007 0007 0007 0007 0007 0007 0007 0002 0007 0007 0007 0007 0007 0007 0310 0007 0002 0007 0007 0007 0007 0007 0007 0007 0007 0007 0007 0007 0007 0002 0000 0006 0210 0006 0006 0000 
0002 0007 0007 0007 0007 0007 0007 0007 0007 0007 0007 0002 0007 0007 0007 0007 0007 0007 0007 0007 0002 0007 0007 0007 0007 0007 0007 0007 0007 0007 0007 0007 0007 0002 0000 0006 0006 0006 0006 0000 
0002 0001 0007 0007 0007 0005 0005 0007 0007 0007 0001 0002 0001 0007 0007 0007 0007 0007 0007 0007 0001 0002 0001 0002 0007 0007 0007 0007 0007 0002 0002 0002 0002 0001 0000 0006 0006 0006 0006 0000 
0002 0002 0002 0002 0002 0002 0002 0002 0002 0002 0002 0002 0002 0002 0002 0002 0002 0002 0002 0002 0002 0002 0002 0001 0002 9999 9999 9999 0002 0001 0000 0000 0000 0000 0000 0000 0000 0000 0000 0000 
