0002 0002 0002 0002 0002 0002 0002 0002 0002 0002 0002 0002 0002 0002 0002 0002 0002 0002 0002 0002 0002 0002 0002 0002 0002 0002 0002 0002 0002 0002 0002 0002 0002 0002 0002 0002 0002 0002 0002 0002 0002 0002 0002 0002 0002 0002 0002 0002 0002 0002 0002 0002 0002 0002 0002 0002 0002 0002 0002 0002 0002 0002 0002 0002 0002 0002 0002 0002 0002 0002 0002 0002 0002 0002 0002 0002 0002 0002 0002 0002 
0002 0002 0002 0002 0002 0002 0002 0002 0002 0002 0002 0002 0002 0002 0002 0002 0002 0002 0002 0002 0002 0002 0002 0002 0002 0002 0002 0002 0002 0002 0002 0002 0002 0002 0002 0002 0002 0002 0002 0002 0002 0002 0002 0002 0002 0002 0002 0002 0002 0002 0002 0002 0002 0002 0002 0002 0002 0002 0002 0002 0002 0002 0002 0002 0002 0002 0002 0002 0002 0002 0002 0002 0002 0002 0002 0002 0002 0002 0002 0002 
0002 0002 0003 0008 0008 0008 0610 0014 0002 0002 0005 0008 0008 0008 0008 0008 0008 0008 0008 0008 0008 0008 0005 0002 0001 0008 0008 0008 0008 0008 0008 0008 0008 0008 0001 0002 0002 0003 0310 0008 0008 0008 0008 0008 0008 0008 0005 0005 0008 0008 0008 0008 0008 0008 0008 0001 0008 0008 0008 0002 0001 0007 0007 0002 0007 0007 0007 0007 0007 0005 0007 0007 0007 0007 0007 0007 0007 0001 0002 0002 
0002 0002 0008 0008 0008 0008 0008 0008 0002 0002 0008 0008 0008 0001 0008 0008 0008 0008 0008 0008 0008 0008 0008 0002 0008 0008 0008 0008 0008 0008 0008 0008 0008 0008 0008 0002 0002 0008 0008 0008 0008 0008 0008 0008 0008 0008 0008 0008 0008 0008 0008 0008 0008 0008 0008 0008 0008 0008 0008 0002 0007 0007 0007 0002 0007 0007 0007 0007 0007 0007 0007 0007 0007 0007 0007 0007 0007 0007 0002 0002 
0002 0002 0008 0008 0002 0002 0002 0002 0002 0002 0008 0008 0008 0008 0008 0008 0008 0008 0008 0008 0002 0008 0008 0002 0008 0008 0008 0002 0008 0008 0008 0008 0008 0008 0008 0002 0002 0008 0008 0008 0008 0008 0008 0008 0008 0008 0008 0008 0008 0008 0008 0008 0008 0008 0008 0008 0008 0008 0008 0002 0007 0007 0007 0002 0007 0007 0007 0007 0007 0007 0007 0007 0007 0007 0007 0007 0007 0007 0002 0002 
0002 0002 0512 0512 0002 0002 0002 0002 0002 0002 0008 0008 0008 0008 0008 0008 0008 0008 0008 0008 0002 0008 0008 0002 0008 0008 0008 0002 0008 0008 0008 0002 0008 0008 0008 0002 0002 0008 0008 0008 0008 0008 0008 0008 0002 0002 0002 0002 0002 0002 0002 0002 0002 0002 0002 0002 0002 0008 0008 0002 0007 0007 0007 0002 0007 0007 0007 0002 0002 0002 0002 0002 0002 0002 0002 0007 0007 0007 0002 0002 
0002 0002 0008 0008 0008 0008 0008 0008 0008 0008 0008 0008 0002 0008 0008 0008 0008 0008 0008 0008 0002 0008 0008 0002 0008 0008 0008 0002 0008 0008 0008 0002 0008 0008 0008 0002 0002 0008 0008 0008 0008 0008 0008 0008 0002 0008 0008 0008 0008 0008 0008 0008 0008 0008 0008 0003 0002 0008 0008 0002 0007 0007 0007 0007 0007 0007 0007 0002 0007 0007 0007 0007 0007 0007 0002 0007 0007 0007 0002 0002 
0002 0002 0008 0008 0008 0008 0008 0008 0008 0008 0008 0008 0002 0008 0008 0008 0008 0008 0008 0008 0002 0008 0008 0002 0008 0008 0008 0002 0008 0008 0008 0002 0008 0008 0008 0002 0002 0008 0008 0008 0008 0008 0008 0008 0002 0008 0008 0008 0008 0008 0008 0008 0008 0008 0008 0008 0002 0008 0008 0002 0007 0007 0007 0007 0007 0007 0007 0002 0007 0007 0007 0007 0007 0007 0002 0007 0007 0007 0002 0002 
0002 0002 0008 0008 0008 0008 0008 0002 0002 0002 0002 0002 0002 0008 0008 0008 0008 0008 0008 0008 0002 0008 0008 0002 0002 0002 0002 0002 0008 0008 0008 0002 0008 0008 0008 0002 0002 0008 0008 0008 0008 0008 0008 0008 0002 0008 0008 0008 0008 0008 0008 0008 0008 0008 0008 0008 0002 0008 0008 0002 0007 0007 0007 0007 0007 0007 0007 0002 0007 0007 0007 0002 0007 0007 0002 0007 0007 0007 0002 0002 
0002 0002 0008 0008 0008 0008 0008 0008 0003 0002 0008 0008 0008 0008 0008 0008 0008 0002 0002 0002 0002 0008 0008 0002 0008 0008 0008 0008 0008 0008 0008 0002 0008 0008 0008 0002 0002 0005 0008 0008 0008 0008 0008 0008 0002 0008 0008 0008 0002 0002 0002 0002 0002 0008 0008 0008 0002 0008 0008 0002 0007 0007 0002 0002 0002 0002 0002 0002 0007 0007 0007 0002 0007 0007 0002 0007 0007 0007 0002 0002 
0002 0002 0008 0008 0008 0008 0008 0008 0008 0002 0008 0008 0008 0008 0008 0008 0008 0002 0008 0002 0002 0008 0008 0002 0008 0005 0008 0008 0008 0008 0008 0002 0008 0008 0008 0002 0002 0005 0008 0008 0008 0008 0008 0008 0002 0008 0008 0008 0002 0410 0003 0002 0002 0008 0008 0008 0002 0008 0008 0002 0007 0007 0007 0007 0007 0007 0007 0007 0007 0007 0007 0002 0007 0007 0002 0007 0007 0007 0002 0002 
0002 0002 0003 0008 0008 0008 0008 0008 0008 0002 0008 0008 0008 0008 0008 0008 0008 0002 0008 0008 0008 0008 0008 0002 0008 0008 0008 0008 0008 0008 0008 0002 0008 0008 0008 0002 0002 0008 0008 0008 0008 0008 0008 0008 0002 0008 0008 0008 0002 0008 0008 0002 0002 0008 0008 0008 0002 0008 0008 0002 0007 0007 0007 0007 0007 0007 0007 0007 0007 0007 0007 0002 0007 0007 0002 0007 0007 0007 0002 0002 
0002 0002 0002 0002 0002 0002 0008 0008 0008 0002 0008 0008 0008 0008 0008 0001 0008 0002 0008 0008 0008 0008 0008 0008 0008 0008 0008 0008 0008 0008 0008 0002 0008 0008 0008 0002 0002 0008 0008 0008 0008 0008 0008 0003 0002 0008 0008 0008 0002 0008 0008 0002 0002 0008 0008 0008 0002 0008 0008 0002 0001 0007 0007 0007 0007 0007 0007 0007 0007 0007 0001 0002 0007 0007 0002 0007 0007 0007 0002 0002 
0002 0002 0008 0008 0008 0008 0008 0008 0008 0002 0008 0008 0008 0002 0002 0002 0002 0002 0008 0008 0008 0008 0008 0008 0008 0008 0008 0002 0002 0002 0002 0002 0008 0008 0008 0002 0002 0008 0008 0008 0002 0002 0002 0002 0002 0008 0008 0008 0002 0312 0312 0002 0002 0008 0008 0008 0002 0008 0008 0002 0002 0002 0002 0002 0002 0002 0002 0002 0002 0002 0002 0002 0007 0007 0002 0007 0007 0007 0002 0002 
0002 0002 0008 0008 0008 0008 0008 0008 0008 0002 0008 0008 0008 0002 0008 0008 0008 0008 0008 0008 0008 0008 0008 0008 0008 0008 0003 0002 0008 0008 0510 0002 0008 0008 0008 0002 0002 0008 0008 0008 0002 0008 0008 0008 0008 0008 0008 0008 0008 0008 0008 0008 0002 0008 0008 0008 0002 0008 0008 0008 0008 0008 0003 0002 0007 0007 0007 0007 0007 0007 0007 0002 0007 0007 0002 0007 0007 0007 0002 0002 
0002 0002 0008 0008 0008 0008 0008 0008 0005 0002 0008 0008 0008 0002 0002 0002 0002 0002 0002 0002 0002 0002 0002 0002 0002 0002 0002 0002 0008 0008 0008 0002 0008 0008 0008 0002 0002 0008 0008 0008 0002 0002 0002 0002 0002 0002 0002 0002 0008 0008 0008 0008 0002 0008 0008 0008 0002 0002 0002 0002 0008 0008 0008 0002 0007 0007 0007 0007 0007 0007 0007 0002 0007 0007 0002 0007 0007 0007 0002 0002 
0002 0002 0008 0008 0008 0008 0008 0008 0008 0002 0008 0008 0008 0008 0008 0008 0008 0008 0008 0008 0008 0008 0008 0002 0002 0005 0008 0008 0008 0008 0008 0002 0008 0008 0008 0002 0002 0008 0008 0008 0008 0008 0008 0008 0008 0008 0008 0002 0008 0008 0008 0008 0002 0008 0008 0008 0008 0008 0008 0008 0008 0008 0008 0002 0007 0007 0007 0007 0007 0007 0007 0002 0007 0007 0002 0007 0007 0007 0002 0002 
0002 0002 0008 0008 0008 0008 0008 0008 0008 0002 0008 0008 0008 0008 0008 0008 0008 0008 0008 0008 0008 0001 0008 0002 0002 0008 0008 0008 0008 0008 0008 0002 0008 0008 0008 0002 0002 0008 0008 0008 0008 0008 0008 0008 0008 0008 0003 0002 0008 0008 0008 0008 0002 0008 0008 0008 0008 0008 0008 0008 0008 0008 0008 0002 0001 0007 0007 0007 0007 0007 0007 0007 0007 0007 0002 0007 0007 0007 0002 0002 
0002 0002 0008 0001 0008 0008 0008 0008 0008 0002 0008 0008 0008 0008 0008 0008 0008 0008 0008 0008 0008 0008 0008 0002 0002 0008 0008 0008 0008 0008 0008 0002 0008 0008 0008 0002 0002 0008 0008 0008 0008 0008 0008 0008 0001 0008 0008 0002 0008 0008 0008 0008 0002 0008 0008 0008 0008 0008 0008 0008 0008 0008 0008 0002 0007 0007 0007 0007 0007 0007 0007 0007 0007 0007 0002 0007 0007 0007 0002 0002 
0002 0002 0008 0008 0008 0008 0008 0008 0008 0002 0008 0008 0002 0002 0002 0002 0002 0002 0002 0002 0008 0008 0008 0002 0002 0008 0008 0002 0002 0002 0002 0002 0008 0008 0008 0002 0002 0003 0008 0008 0008 0008 0008 0008 0008 0008 0008 0002 0008 0008 0008 0008 0002 0008 0008 0008 0008 0008 0008 0008 0008 0003 0008 0002 0007 0007 0007 0007 0007 0007 0007 0007 0007 0007 0002 0007 0007 0007 0002 0002 
0002 0002 0002 0002 0002 0002 0002 0002 0002 0002 0008 0008 0002 0008 0008 0008 0008 0008 0008 0008 0008 0008 0008 0002 0002 0008 0008 0002 0008 0008 0008 0008 0008 0008 0008 0002 0002 0002 0002 0002 0002 0002 0002 0002 0008 0008 0008 0002 0008 0008 0008 0008 0002 0002 0002 0002 0002 0002 0002 0002 0002 0002 0002 0002 0007 0007 0007 0007 0007 0007 0007 0007 0007 0007 0002 0007 0007 0007 0002 0002 
0002 0002 0003 0008 0008 0008 0008 0008 0008 0002 0008 0008 0002 0003 0008 0008 0008 0008 0008 0008 0008 0008 0008 0002 0002 0008 0008 0002 0008 0008 0008 0008 0008 0001 0008 0002 0002 0008 0008 0008 0008 0008 0008 0008 0008 0008 0008 0002 0008 0008 0008 0008 0002 0001 0007 0007 0007 0007 0007 0007 0007 0007 0007 0007 0007 0007 0007 0007 0007 0007 0007 0007 0007 0007 0002 0007 0007 0007 0002 0002 
0002 0002 0008 0008 0008 0008 0008 0008 0008 0002 0008 0008 0002 0008 0008 0008 0008 0008 0008 0008 0008 0008 0008 0002 0002 0008 0008 0002 0008 0008 0008 0008 0008 0008 0008 0002 0002 0008 0008 0008 0008 0008 0008 0008 0008 0008 0008 0002 0008 0008 0008 0008 0002 0007 0007 0007 0007 0007 0007 0007 0007 0007 0007 0007 0007 0007 0007 0007 0005 0007 0007 0007 0007 0007 0002 0007 0007 0007 0002 0002 
0002 0002 0008 0008 0008 0008 0008 0008 0008 0002 0008 0008 0002 0008 0008 0008 0008 0008 0008 0008 0008 0008 0008 0002 0002 0008 0008 0002 0008 0008 0008 0008 0008 0008 0008 0002 0002 0008 0008 0008 0008 0008 0008 0008 0008 0008 0008 0002 0008 0008 0008 0008 0002 0007 0007 0007 0007 0007 0007 0002 0002 0002 0002 0002 0002 0002 0002 0002 0002 0002 0002 0002 0002 0002 0002 0001 0007 0007 0002 0002 
0002 0002 0008 0008 0008 0008 0008 0008 0008 0002 0008 0008 0002 0008 0008 0008 0008 0002 0002 0002 0002 0002 0002 0002 0002 0008 0008 0008 0008 0008 0008 0008 0002 0002 0002 0002 0002 0008 0008 0008 0002 0002 0002 0002 0002 0002 0002 0002 0008 0008 0008 0008 0002 0007 0007 0007 0110 0007 0007 0002 0002 0002 0002 0002 0002 0002 0002 0002 0002 0002 0002 0002 0002 0002 0002 0002 0112 0112 0002 0002 
0002 0002 0005 0008 0008 0008 0008 0008 0008 0002 0008 0008 0002 0008 0008 0008 0008 0008 0008 0008 0008 0002 0008 0008 0008 0008 0008 0008 0008 0008 0001 0008 0002 0008 0008 0014 0008 0008 0008 0008 0008 0008 0008 0002 0008 0008 0008 0008 0008 0008 0008 0008 0002 0007 0007 0007 0007 0007 0007 0002 0001 0007 0007 0007 0007 0007 0007 0007 0007 0007 0007 0007 0007 0007 0007 0007 0007 0007 0002 0002 
0002 0002 0008 0008 0008 0008 0008 0008 0008 0002 0008 0008 0002 0005 0008 0008 0008 0008 0008 0008 0008 0002 0008 0008 0008 0008 0008 0008 0008 0008 0008 0008 0002 0008 0008 0008 0008 0008 0008 0008 0008 0008 0008 0002 0008 0008 0008 0008 0008 0008 0008 0008 0002 0001 0007 0007 0007 0007 0007 0002 0007 0007 0007 0007 0007 0007 0007 0007 0007 0007 0007 0007 0007 0007 0007 0007 0007 0007 0002 0002 
0002 0002 0008 0008 0008 0008 0008 0008 0003 0002 0008 0008 0002 0002 0002 0002 0002 0008 0008 0008 0008 0002 0008 0008 0008 0008 0008 0008 0008 0008 0008 0008 0002 0008 0008 0008 0008 0008 0008 0008 0008 0005 0008 0002 0008 0008 0008 0008 0008 0008 0008 0008 0002 0007 0007 0007 0007 0007 0014 0002 0007 0007 0007 0007 0007 0007 0007 0007 0007 0007 0007 0007 0007 0007 0007 0007 0007 0007 0002 0002 
9999 0008 0008 0008 0008 0008 0008 0002 0002 0002 0008 0008 0002 0002 0002 0002 0002 0008 0008 0008 0008 0002 0008 0008 0008 0002 0002 0002 0002 0002 0002 0002 0002 0008 0008 0008 0008 0008 0008 0008 0008 0008 0008 0002 0008 0008 0008 0002 0002 0002 0002 0002 0002 0002 0002 0002 0002 0002 0002 0002 0007 0007 0007 0002 0002 0002 0002 0002 0002 0002 0002 0002 0002 0002 0002 0007 0007 0007 0002 0002 
9999 0008 0008 0008 0008 0008 0008 0612 0008 0008 0008 0008 0002 0008 0008 0008 0008 0008 0008 0008 0008 0002 0008 0008 0008 0008 0008 0008 0008 0008 0008 0008 0002 0008 0008 0008 0008 0008 0008 0008 0008 0008 0008 0002 0008 0008 0008 0008 0008 0008 0008 0008 0008 0008 0008 0008 0008 0008 0008 0002 0007 0007 0007 0007 0007 0007 0002 0002 0007 0007 0007 0007 0007 0007 0007 0007 0007 0007 0002 0002 
0002 0002 0008 0008 0008 0008 0008 0612 0008 0008 0008 0008 0002 0008 0008 0008 0008 0008 0008 0008 0008 0002 0008 0008 0008 0008 0008 0008 0008 0008 0008 0008 0002 0008 0008 0008 0008 0008 0008 0008 0008 0008 0008 0002 0008 0008 0008 0008 0008 0008 0008 0008 0008 0008 0008 0008 0008 0008 0008 0002 0007 0007 0007 0007 0007 0007 0002 0002 0001 0007 0007 0007 0007 0007 0007 0007 0007 0001 0002 0002 
0002 0002 0008 0008 0008 0008 0008 0002 0002 0002 0002 0002 0002 0008 0008 0008 0008 0008 0008 0008 0008 0002 0003 0008 0008 0008 0008 0008 0008 0008 0008 0008 0002 0008 0008 0008 0008 0008 0008 0008 0008 0008 0008 0002 0001 0008 0008 0008 0008 0008 0008 0008 0008 0008 0008 0008 0008 0008 0008 0002 0001 0007 0007 0007 0007 0007 0002 0002 0002 0002 0002 0002 0002 0002 0002 0002 0002 0002 0002 0002 
0002 0002 0008 0008 0008 0008 0008 0008 0008 0008 0008 0008 0008 0008 0008 0008 0002 0002 0002 0002 0002 0002 0002 0002 0002 0002 0002 0002 0002 0008 0008 0008 0002 0008 0008 0008 0008 0008 0008 0002 0002 0002 0002 0002 0002 0002 0002 0002 0002 0002 0002 0002 0002 0002 0002 0002 0002 0008 0008 0002 0002 0002 0002 0007 0007 0007 0007 0007 0007 0007 0007 0007 0007 0007 0007 0007 0007 0007 0002 0002 
0002 0002 0008 0008 0008 0008 0008 0008 0008 0008 0008 0008 0008 0008 0001 0008 0002 0007 0007 0007 0007 0007 0007 0007 0007 0007 0007 0007 0002 0008 0008 0008 0412 0008 0008 0008 0008 0008 0008 0002 0007 0007 0007 0007 0007 0007 0007 0007 0007 0007 0007 0007 0007 0007 0007 0002 0002 0008 0008 0008 0008 0003 0002 0007 0007 0007 0007 0007 0007 0007 0007 0007 0007 0007 0007 0007 0007 0007 0002 0002 
0002 0002 0001 0008 0003 0008 0008 0008 0008 0008 0008 0008 0003 0008 0008 0008 0002 0007 0007 0007 0007 0007 0007 0007 0007 0007 0007 0001 0002 0008 0008 0008 0412 0008 0008 0008 0008 0008 0008 0002 0007 0007 0007 0007 0007 0007 0007 0007 0007 0007 0007 0007 0007 0007 0007 0002 0002 0008 0008 0008 0008 0008 0002 0007 0007 0007 0007 0007 0007 0007 0007 0007 0007 0007 0007 0007 0007 0007 0002 0002 
0002 0002 0002 0002 0002 0002 0002 0002 0002 0002 0002 0002 0002 0002 0002 0002 0002 0007 0007 0002 0002 0002 0002 0002 0007 0007 0007 0007 0002 0002 0002 0002 0002 0002 0002 0005 0002 0002 0002 0002 0002 0002 0002 0002 0002 0002 0002 0002 0007 0007 0007 0007 0002 0007 0007 0002 0002 0003 0008 0008 0008 0008 0002 0007 0007 0007 0007 0007 0007 0007 0007 0007 0007 0007 0002 0007 0007 0007 0002 0002 
0002 0002 0001 0007 0007 0007 0007 0007 0002 0007 0007 0007 0007 0007 0007 0001 0002 0007 0007 0002 0007 0007 0007 0002 0007 0007 0007 0007 0007 0007 0007 0007 0007 0007 0007 0007 0007 0007 0007 0007 0007 0007 0007 0007 0007 0001 0007 0002 0007 0007 0007 0007 0002 0007 0007 0002 0002 0002 0002 0002 0008 0008 0002 0002 0002 0002 0002 0002 0002 0002 0002 0002 0007 0007 0002 0007 0007 0007 0002 0002 
0002 0002 0007 0007 0007 0007 0007 0007 0002 0007 0007 0007 0007 0007 0007 0007 0002 0007 0007 0002 0007 0007 0007 0002 0007 0007 0007 0007 0007 0007 0007 0007 0007 0007 0007 0007 0007 0007 0007 0007 0007 0007 0007 0007 0007 0007 0007 0002 0007 0007 0007 0007 0002 0007 0007 0007 0007 0007 0007 0002 0008 0008 0212 0007 0007 0007 0007 0007 0007 0007 0007 0002 0007 0007 0002 0007 0007 0007 0002 0002 
0002 0002 0007 0007 0007 0007 0007 0007 0002 0007 0007 0007 0007 0007 0007 0007 0002 0007 0007 0002 0007 0007 0007 0002 0005 0007 0007 0007 0007 0007 0007 0007 0007 0007 0007 0007 0007 0007 0007 0007 0007 0007 0007 0007 0007 0007 0007 0002 0007 0007 0007 0007 0002 0007 0007 0007 0007 0007 0007 0002 0008 0008 0212 0007 0007 0007 0007 0007 0007 0007 0007 0002 0007 0007 0002 0007 0007 0007 0002 0002 
0002 0002 0007 0007 0002 0007 0007 0007 0002 0007 0007 0007 0002 0007 0007 0007 0002 0007 0007 0002 0007 0007 0007 0002 0002 0002 0002 0002 0002 0007 0007 0002 0002 0002 0002 0002 0002 0002 0002 0002 0002 0002 0002 0002 0002 0007 0007 0002 0002 0002 0002 0002 0002 0007 0007 0007 0002 0007 0007 0002 0001 0007 0002 0007 0007 0007 0007 0007 0007 0007 0007 0002 0007 0007 0002 0007 0007 0007 0002 0002 
0002 0002 0007 0007 0002 0007 0007 0001 0002 0007 0007 0007 0002 0007 0007 0007 0002 0007 0007 0002 0007 0007 0001 0002 0007 0007 0007 0007 0007 0007 0007 0002 0002 0002 0002 0002 0002 0002 0002 0002 0002 0002 0002 0002 0002 0007 0007 0002 0007 0007 0007 0007 0007 0007 0007 0007 0002 0007 0007 0002 0002 0002 0002 0002 0002 0002 0002 0007 0007 0007 0007 0002 0007 0007 0002 0007 0007 0007 0002 0002 
0002 0002 0007 0007 0002 0007 0007 0007 0007 0007 0007 0007 0002 0007 0007 0007 0007 0007 0007 0002 0007 0007 0007 0002 0007 0007 0007 0007 0007 0007 0007 0002 0007 0007 0007 0007 0007 0007 0002 0002 0007 0007 0007 0007 0002 0007 0007 0002 0007 0007 0007 0007 0007 0007 0007 0007 0002 0007 0007 0007 0007 0007 0007 0007 0007 0007 0002 0007 0007 0007 0007 0002 0007 0007 0002 0007 0007 0007 0002 0002 
0002 0002 0007 0007 0002 0007 0007 0007 0007 0007 0007 0007 0002 0007 0007 0007 0007 0007 0007 0002 0007 0007 0007 0002 0007 0007 0007 0007 0007 0007 0007 0002 0001 0007 0007 0007 0007 0007 0002 0002 0007 0007 0007 0007 0002 0007 0007 0002 0007 0007 0007 0007 0007 0007 0007 0007 0002 0007 0007 0007 0007 0007 0007 0007 0007 0007 0002 0007 0007 0007 0007 0002 0007 0007 0002 0007 0007 0007 0002 0002 
0002 0002 0007 0007 0002 0002 0002 0002 0002 0002 0002 0002 0002 0002 0002 0002 0002 0002 0002 0002 0007 0007 0007 0002 0007 0007 0007 0002 0007 0007 0007 0002 0007 0007 0007 0007 0007 0007 0002 0002 0007 0007 0007 0007 0002 0007 0007 0002 0007 0007 0007 0007 0007 0007 0007 0007 0002 0007 0007 0007 0007 0007 0002 0002 0002 0002 0002 0007 0007 0007 0007 0002 0007 0007 0002 0007 0007 0007 0002 0002 
0002 0002 0007 0007 0002 0007 0007 0007 0007 0007 0007 0007 0007 0007 0007 0007 0007 0007 0007 0007 0007 0007 0007 0002 0007 0007 0007 0002 0007 0007 0007 0002 0007 0007 0007 0007 0007 0007 0002 0002 0007 0007 0007 0007 0002 0007 0007 0007 0007 0007 0007 0002 0002 0002 0002 0002 0002 0002 0002 0007 0007 0007 0002 0001 0007 0007 0007 0007 0007 0007 0007 0002 0007 0007 0002 0007 0007 0007 0002 0002 
0002 0002 0007 0007 0002 0007 0001 0007 0007 0007 0007 0007 0007 0007 0007 0007 0007 0007 0007 0007 0007 0007 0007 0002 0007 0007 0007 0002 0007 0007 0007 0002 0007 0007 0007 0007 0007 0007 0002 0002 0007 0007 0007 0007 0002 0007 0007 0007 0007 0007 0007 0002 0001 0007 0005 0007 0007 0001 0002 0007 0007 0007 0002 0007 0007 0007 0007 0007 0007 0007 0007 0002 0001 0007 0002 0007 0007 0007 0002 0002 
0002 0002 0007 0007 0002 0007 0007 0007 0002 0007 0007 0007 0007 0007 0007 0007 0007 0007 0007 0007 0007 0007 0007 0002 0007 0007 0007 0002 0007 0007 0007 0002 0007 0007 0007 0007 0007 0007 0002 0002 0007 0007 0007 0007 0002 0002 0002 0002 0002 0007 0007 0002 0007 0007 0007 0007 0007 0007 0002 0007 0007 0007 0002 0007 0007 0007 0002 0002 0002 0002 0002 0002 0002 0002 0002 0007 0007 0007 0002 0002 
0002 0002 0007 0007 0002 0007 0007 0007 0002 0007 0007 0007 0210 0007 0007 0007 0007 0007 0002 0002 0007 0007 0007 0002 0007 0007 0007 0002 0002 0002 0002 0002 0005 0007 0007 0007 0007 0007 0002 0002 0007 0007 0007 0007 0007 0007 0007 0007 0007 0007 0007 0002 0007 0007 0007 0007 0007 0007 0002 0007 0007 0007 0002 0007 0007 0007 0007 0007 0007 0007 0002 0002 0007 0007 0007 0007 0007 0007 0002 0002 
0002 0002 0007 0007 0007 0007 0007 0007 0002 0007 0007 0007 0007 0007 0007 0007 0007 0007 0002 0002 0007 0007 0007 0002 0007 0007 0007 0007 0007 0007 0007 0002 0007 0007 0007 0007 0007 0007 0002 0002 0007 0007 0007 0007 0007 0007 0007 0007 0007 0007 0007 0002 0007 0007 0007 0007 0007 0007 0002 0007 0007 0007 0002 0007 0007 0007 0007 0007 0007 0007 0002 0002 0007 0007 0007 0007 0007 0007 0002 0002 
0002 0002 0007 0007 0007 0007 0007 0007 0002 0007 0007 0007 0007 0007 0007 0007 0007 0007 0002 0002 0007 0007 0007 0002 0007 0007 0007 0007 0007 0007 0007 0002 0007 0007 0007 0007 0007 0007 0002 0002 0007 0007 0007 0007 0007 0007 0007 0007 0007 0007 0007 0002 0007 0007 0007 0007 0007 0007 0002 0001 0007 0007 0002 0007 0007 0007 0007 0007 0007 0007 0002 0002 0007 0007 0007 0007 0007 0001 0002 0002 
0002 0002 0007 0007 0007 0007 0007 0007 0002 0007 0007 0005 0007 0007 0007 0007 0007 0005 0002 0002 0002 0002 0002 0002 0002 0002 0002 0002 0002 0007 0007 0002 0007 0007 0007 0007 0007 0007 0002 0002 0002 0002 0002 0002 0002 0002 0002 0002 0002 0002 0002 0002 0007 0007 0007 0007 0007 0007 0002 0002 0002 0002 0002 0002 0002 0002 0002 0002 0007 0007 0002 0002 0007 0007 0002 0002 0002 0002 0002 0002 
0002 0002 0002 0002 0002 0002 0002 0002 0002 0002 0002 0002 0007 0007 0007 0007 0007 0007 0002 0002 0007 0007 0007 0007 0007 0007 0007 0007 0007 0007 0007 0002 0007 0001 0007 0007 0007 0007 0002 0002 0001 0007 0007 0007 0007 0007 0007 0007 0007 0007 0007 0007 0007 0007 0007 0007 0007 0007 0007 0007 0007 0007 0002 0007 0007 0007 0007 0007 0007 0007 0002 0002 0007 0007 0007 0007 0007 0007 0002 0002 
0002 0002 0001 0007 0007 0007 0007 0007 0007 0007 0007 0007 0007 0007 0007 0007 0007 0007 0002 0002 0007 0007 0007 0007 0007 0007 0007 0007 0007 0007 0007 0002 0007 0007 0007 0007 0007 0007 0002 0002 0007 0007 0007 0007 0007 0007 0005 0007 0007 0007 0007 0007 0007 0007 0007 0007 0007 0007 0007 0007 0007 0007 0002 0007 0007 0007 0007 0007 0007 0007 0002 0002 0007 0007 0007 0007 0007 0007 0002 0002 
0002 0002 0007 0007 0007 0007 0007 0007 0007 0007 0007 0007 0007 0007 0007 0007 0007 0007 0002 0002 0007 0007 0007 0007 0007 0007 0007 0007 0007 0007 0007 0002 0007 0007 0007 0007 0007 0007 0002 0002 0007 0007 0007 0007 0007 0007 0007 0007 0007 0007 0007 0007 0007 0007 0007 0007 0007 0007 0007 0007 0007 0007 0002 0007 0007 0007 0007 0007 0007 0007 0002 0002 0007 0007 0007 0007 0007 0007 0002 0002 
0002 0002 0007 0007 0002 0002 0002 0002 0002 0002 0007 0007 0007 0007 0007 0007 0007 0007 0002 0002 0007 0007 0007 0002 0002 0002 0002 0002 0002 0002 0002 0002 0007 0007 0007 0002 0007 0007 0002 0002 0007 0007 0007 0007 0007 0007 0007 0007 0007 0007 0007 0007 0007 0007 0007 0007 0007 0007 0007 0007 0007 0007 0007 0007 0007 0007 0007 0007 0007 0007 0002 0002 0007 0007 0007 0007 0007 0007 0002 0002 
0002 0002 0007 0007 0007 0007 0007 0007 0007 0002 0007 0007 0007 0007 0007 0007 0007 0007 0002 0002 0007 0007 0007 0007 0007 0007 0007 0007 0007 0007 0007 0007 0007 0007 0007 0002 0007 0007 0002 0002 0001 0007 0007 0007 0007 0007 0007 0007 0007 0007 0002 0002 0002 0002 0002 0002 0007 0007 0007 0007 0007 0007 0007 0007 0007 0007 0007 0007 0007 0007 0007 0007 0007 0007 0007 0007 0007 0007 0002 0002 
0002 0002 0007 0001 0007 0007 0007 0014 0007 0002 0007 0007 0007 0007 0007 0001 0007 0007 0002 0002 0007 0007 0001 0007 0007 0007 0007 0007 0007 0007 0007 0007 0007 0007 0007 0002 0007 0007 0007 0007 0007 0007 0007 0007 0007 0007 0007 0007 0007 0007 0007 0007 0007 0007 0007 0002 0007 0007 0007 0007 0007 0007 0007 0007 0007 0007 0007 0007 0007 0007 0007 0007 0007 0007 0007 0007 0007 0007 0002 0002 
0002 0002 0007 0007 0007 0007 0007 0007 0007 0002 0007 0007 0007 0007 0007 0007 0007 0005 0002 0002 0007 0007 0007 0007 0007 0007 0007 0007 0007 0007 0007 0007 0007 0007 0007 0002 0007 0007 0007 0007 0007 0007 0007 0007 0007 0007 0007 0007 0007 0007 0007 0007 0007 0007 0007 0002 0001 0005 0005 0001 0007 0007 0007 0007 0007 0001 0007 0001 0007 0007 0007 0007 0007 0007 0001 0005 0005 0001 0002 0002 
0002 0002 0002 0002 0002 0002 0002 0002 0002 0002 0002 0002 0002 0002 0002 0002 0002 0002 0002 0002 0002 0002 0002 0002 0002 0002 0002 0002 0002 0002 0002 0002 0002 0002 0002 0002 0002 0002 0002 0002 0002 0002 0002 0002 0002 0002 0002 0002 0002 0002 0002 0002 0002 0002 0002 0002 0002 0002 0002 0002 0002 0002 0002 0002 0002 0002 0005 0002 0002 0002 0002 0002 0002 0002 0002 0002 0002 0002 0002 0002 
0002 0002 0002 0002 0002 0002 0002 0002 0002 0002 0002 0002 0002 0002 0002 0002 0002 0002 0002 0002 0002 0002 0002 0002 0002 0002 0002 0002 0002 0002 0002 0002 0002 0002 0002 0002 0002 0002 0002 0002 0002 0002 0002 0002 0002 0002 0002 0002 0002 0002 0002 0002 0002 0002 0002 0002 0002 0002 0002 0002 0002 0002 0002 0002 0002 0002 0002 0002 0002 0002 0002 0002 0002 0002 0002 0002 0002 0002 0002 0002 
